Season,DayNum,WTeamID,WScore,LTeamID,LScore,WLoc,NumOT,ScoreDiff,WSeed,LSeed,SeedDiff,flip,ScoreDiffAdj,SeedDiffAdj,FGMDiffAdj,FGADiffAdj,FGM3DiffAdj,FGA3DiffAdj,FTMDiffAdj,FTADiffAdj,ORDiffAdj,DRDiffAdj,AstDiffAdj,TODiffAdj,StlDiffAdj,BlkDiffAdj,PFDiffAdj
2010,134,1115,61,1457,44,N,0,17,16,16,0,1,17,0,-0.848567119155355,-6.280693815987938,0.2046757164404216,-1.596380090497739,4.069230769230769,5.350829562594271,-1.0244343891402714,1.142684766214181,1.7141779788838605,4.628959276018101,-1.9473604826546005,-0.21704374057315245,3.7695324283559586
2010,136,1124,68,1358,59,N,0,9,3,14,-11,1,9,-11,-0.1547619047619051,-3.6190476190476133,-2.2351190476190483,-5.3601190476190474,-1.2083333333333321,-2.529761904761905,-0.2172619047619051,2.3363095238095255,-5.791666666666668,0.8184523809523832,-1.2976190476190474,4.366071428571429,-1.6309523809523796
2010,136,1139,77,1431,59,N,0,18,5,12,-7,1,18,-7,-4.777014652014653,-6.6355311355311315,0.4395604395604389,2.098901098901102,1.7165750915750912,-0.8333333333333357,-1.4835164835164854,-2.0966117216117226,-2.488095238095239,-0.6268315018315018,-1.7211538461538467,-0.7467948717948714,-0.7921245421245402
2010,136,1140,99,1196,92,N,2,7,7,10,-3,1,7,-3,0.851190476190478,0.8595238095238145,1.7547619047619056,1.447619047619046,3.359523809523809,1.711904761904762,-3.453571428571429,2.4309523809523768,0.23809523809523903,-1.5535714285714306,0.8309523809523807,0.5357142857142856,3.607142857142854
2010,136,1242,90,1250,74,N,0,16,1,16,-15,1,16,-15,1.7497159090909093,2.021306818181813,0.788636363636364,3.453125,-0.45710227272727266,0.020738636363638818,1.7474431818181806,-0.5059659090909108,-0.994034090909091,-0.44687500000000036,2.050568181818182,2.7585227272727275,1.4676136363636374
2010,136,1243,82,1317,62,N,0,20,2,15,-13,1,20,-13,1.8428246753246782,6.198409090909095,1.0560064935064943,3.010584415584418,0.3954220779220776,3.0467857142857113,4.578506493506495,-2.2769155844155833,1.7239935064935068,-0.9285714285714288,2.929805194805195,1.3492532467532472,5.1012987012987026
2010,136,1246,100,1190,71,N,0,29,1,16,-15,-1,-29,15,-0.5696663533834574,-1.691141917293237,0.8367011278195484,-0.6547227443609032,-2.8687734962405997,-2.387805451127818,-1.361137218045112,-3.0493421052631575,-1.0901080827067666,0.4918937969924819,1.7147556390977439,-3.5171522556390977,1.436090225563909
2010,136,1293,66,1435,65,N,0,1,13,4,9,1,1,9,1.7678571428571423,-0.6731366459627353,0.491847826086957,0.729813664596275,-2.574145962732919,-2.9864130434782616,1.7853260869565215,-2.1816770186335432,1.1599378881987583,1.279503105590063,2.796195652173913,-0.012422360248447006,0.11878881987577827
2010,136,1307,62,1285,57,N,0,5,3,14,-11,-1,-5,11,0.08275862068965623,-5.581704980842908,-1.1429118773946358,-4.402490421455937,-4.359386973180079,-6.91925287356322,-4.2812260536398465,-0.8877394636015303,-1.9544061302681985,0.7798850574712635,0.3682950191570882,-0.4108237547892717,1.1663793103448263
2010,136,1320,69,1424,66,N,0,3,9,8,1,1,3,1,-5.315476190476193,-6.398809523809533,-0.0625,0.3392857142857153,0.3482142857142847,-0.514880952380949,0.2113095238095255,-0.19047619047619335,-4.839285714285715,-0.8125,-2.8154761904761916,-1.458333333333333,-3.336309523809522
2010,136,1325,97,1207,83,N,0,14,14,3,11,-1,-14,-11,1.2961180124223581,-5.246428571428574,-1.0939440993788825,-4.016304347826086,-3.136335403726708,-3.6138198757764,-1.7745341614906813,-2.1919254658385086,1.3152173913043477,1.1368012422360252,-0.5909937888198762,2.0318322981366457,-1.8094720496894396
2010,136,1330,51,1323,50,N,0,1,11,6,5,-1,-1,-5,1.3323388567953778,0.10403998175736717,3.207034813013074,5.038955609607784,4.595355731225297,4.571602310732747,-3.1939229249011856,1.2417908178777743,2.4397423228944977,-3.281430525995745,-1.9811492854971107,0.5214920948616601,-0.5623099726360579
2010,136,1388,80,1350,71,N,0,9,10,7,3,-1,-9,-3,-1.8575000000000017,-1.3540384615384582,-0.7382692307692311,-0.09326923076923066,-2.8876923076923067,-2.6803846153846127,-1.504038461538462,-1.5025000000000013,-2.820961538461537,-1.2873076923076923,2.8021153846153855,0.01807692307692399,0.873461538461541
2010,136,1397,62,1361,59,N,0,3,6,11,-5,-1,-3,5,-0.11239130434782751,-3.844999999999999,0.1109782608695653,-1.3802173913043454,-0.7330434782608695,0.35195652173913317,1.7699999999999996,1.016086956521736,0.29217391304347906,1.0160869565217396,-0.9109782608695651,0.7292391304347832,-3.6614130434782624
2010,136,1437,73,1352,70,N,1,3,2,15,-13,-1,-3,13,-4.053912572934312,-4.471214473931866,-1.7555759457933364,-4.276962168266515,-3.0301501035196683,-1.489165725578765,-0.48857754564276235,-1.4541572557876918,-0.49409467344250046,0.966509034443817,-0.30988848108413336,-1.8355213626952755,-1.8540137398833068
2010,136,1448,81,1400,80,N,1,1,9,8,1,-1,-1,-1,3.0971491228070214,3.1329678362573077,1.1588450292397656,1.5617690058479532,-0.28925438596491304,0.47660818713450226,0.2666666666666657,-0.8024122807017555,2.4567251461988313,-0.5564327485380112,0.5566520467836256,0.7833333333333341,0.20964912280701853
2010,136,1449,80,1266,78,N,0,2,11,6,5,-1,-2,-5,-2.4659090909090935,-4.708333333333329,2.787878787878788,3.874368686868685,-4.002525252525253,-5.907828282828284,-2.304292929292929,-2.4476010101010104,1.8794191919191938,-2.7910353535353547,0.8282828282828278,-1.6098484848484853,-4.537878787878785
2010,137,1143,77,1257,62,N,0,15,8,9,-1,1,15,-1,1.030434782608694,0.24710144927536248,-1.3938405797101439,-5.004347826086956,0.5014492753623188,-0.742391304347823,-2.4981884057971016,1.6373188405797094,-1.0927536231884076,-1.4579710144927542,-1.9242753623188413,-1.6072463768115943,-2.602898550724639
2010,137,1165,78,1396,65,N,0,13,12,5,7,1,13,7,4.304310344827584,-0.5520689655172433,4.860517241379311,6.36086206896552,-0.09362068965517167,-1.5844827586206893,-1.9874137931034497,-1.992068965517241,2.8070689655172387,2.3953448275862073,1.7718965517241383,1.1615517241379312,4.032758620689652
2010,137,1181,73,1115,44,N,0,29,1,16,-15,-1,-29,15,-3.9737660581473975,-7.321839080459775,-3.3142663962136583,-7.307707910750505,0.12494929006085087,3.5624070317782284,-1.484381338742395,2.579242731575391,-0.1566599053414457,5.458417849898581,0.32123056118999394,-0.22805949966193362,2.690534144692357
2010,137,1210,64,1329,59,N,0,5,10,7,3,1,5,3,1.3465367965367996,1.0119047619047592,-1.9831168831168835,-7.421103896103897,-0.9256493506493513,0.9962121212121176,3.7648268398268403,0.7512987012987047,1.711147186147187,3.3573593073593084,1.3504329004329012,3.003679653679654,-1.5589826839826841
2010,137,1211,67,1199,60,N,0,7,8,9,-1,-1,-7,1,-0.9581818181818207,-0.9160606060606042,0.12272727272727302,1.8118181818181789,-4.557676767676767,-6.208181818181821,2.4462626262626266,-1.9189898989898992,0.41515151515151416,3.904040404040405,2.0185858585858583,2.157979797979798,0.07707070707070329
2010,137,1268,89,1222,77,N,0,12,4,13,-9,-1,-12,9,-0.3497474747474776,4.812626262626253,2.784848484848485,7.703156565656563,0.6097222222222225,1.1414141414141419,0.5396464646464665,-3.6974747474747467,-2.439898989898989,-3.517676767676768,1.4362373737373737,-1.5484848484848484,0.993308080808081
2010,137,1277,70,1308,67,N,0,3,5,12,-7,1,3,-7,-0.004058441558438375,-1.4066558441558357,-3.734036796536797,-8.528950216450216,-1.9104437229437217,-2.648538961038966,3.103084415584414,-0.1325757575757578,1.4004329004329001,1.0760281385281374,1.153950216450216,-0.3720238095238093,-0.13663419913419972
2010,137,1281,86,1155,78,N,0,8,10,7,3,-1,-8,-3,-0.5028138528138548,-3.133549783549782,-0.8478354978354989,-0.5584415584415616,-1.0844155844155825,0.6551948051948067,0.9067099567099568,1.5051948051948045,-0.8110389610389603,2.614069264069263,-1.3290043290043307,0.11774891774891838,-0.97099567099567
2010,137,1326,68,1364,51,N,0,17,2,15,-13,1,17,-13,3.5673906989696498,2.859927596769708,-0.07950431634642108,-0.03982177666388509,-2.8205235310498455,-4.422445001392372,-0.25675299359510007,-0.43233082706766623,-0.27680311890838283,-3.703842940685046,0.6423001949317735,1.0672514619883042,-2.212754107490948
2010,137,1338,89,1324,66,N,0,23,3,14,-11,-1,-23,11,1.5625,5.520833333333343,0.45833333333333215,2.958333333333332,0.8333333333333321,0.4583333333333357,0.8125,-0.2708333333333357,-2.083333333333334,2.125,1.25,0.5416666666666665,-0.4583333333333357
2010,137,1345,72,1373,64,N,0,8,4,13,-9,1,8,-9,-3.650000000000002,-5.642592592592592,0.8388888888888895,1.5222222222222257,0.1796296296296287,-1.325925925925926,-4.412962962962965,-2.9888888888888907,-1.4185185185185194,-1.53148148148148,-2.0925925925925926,0.3555555555555552,3.909259259259258
2010,137,1393,79,1436,56,N,0,23,1,16,-15,1,23,-15,6.469206349206345,5.984682539682538,1.482619047619048,2.09,-5.405555555555555,-7.380396825396826,0.4641269841269846,0.46785714285714164,6.456984126984125,-0.12706349206349188,1.8552380952380947,1.383809523809524,-2.489047619047618
2010,137,1401,69,1429,53,N,0,16,5,12,-7,1,16,-7,-2.4526584526584507,-0.27258852258852073,0.096459096459097,2.7504995004994974,5.589022089022089,10.76065601065601,1.6885336885336866,-0.7831612831612809,-3.798729048729049,1.2592685092685105,2.5603008103008094,0.2108447108447109,3.4418081918081924
2010,137,1452,77,1288,50,N,0,27,2,15,-13,-1,-27,13,0.44444444444444287,2.1851851851851904,-1.9351851851851851,-4.435185185185183,3.148148148148149,3.657407407407412,-0.11111111111111072,2.1111111111111143,-3.0925925925925934,1.6018518518518512,1.8148148148148149,-0.11111111111111072,2.018518518518519
2010,137,1458,53,1459,49,N,0,4,4,13,-9,1,4,-9,-0.7959782608695605,-0.9698913043478257,1.6631521739130424,3.4853260869565226,-3.208913043478262,-5.284782608695654,-1.3439130434782616,-1.3021739130434753,-1.438369565217391,-2.351413043478262,-0.9626086956521736,1.4094565217391304,-0.23684782608695443
2010,137,1462,65,1278,54,N,0,11,6,11,-5,-1,-11,5,-1.017628205128208,-4.9269688644688685,-0.06936813186813318,-1.8438644688644672,-3.845238095238095,-5.2884615384615365,-1.6181318681318686,-2.1407967032967044,3.1973443223443248,-0.5121336996337007,0.5405219780219781,1.89010989010989,-3.122481684981686
2010,138,1124,76,1330,68,N,0,8,3,11,-8,1,8,-8,2.27403846153846,0.2754120879120876,2.6749084249084243,3.612866300366301,4.2023809523809526,4.02518315018315,-1.9345238095238102,2.4306318681318686,-0.9590201465201478,0.6806318681318686,-1.2884615384615383,3.886904761904762,2.7758699633699635
2010,138,1139,54,1293,52,N,0,2,5,13,-8,1,2,-8,-4.25,-2.142857142857139,0.1607142857142856,2.696428571428573,2.3392857142857135,1.0,-2.9642857142857153,1.5535714285714306,-1.0357142857142865,-1.7321428571428577,-1.5,-2.1071428571428577,0.1607142857142847
2010,138,1243,84,1140,72,N,0,12,2,7,-5,-1,-12,5,1.2521428571428572,-0.22714285714285865,1.3857142857142861,1.1085714285714268,-2.758571428571429,-8.498571428571424,-6.03857142857143,3.626428571428569,0.8092857142857142,-3.303571428571429,0.5185714285714287,-1.1828571428571433,-4.88214285714286
2010,138,1246,90,1448,60,N,0,30,1,9,-8,1,30,-8,-0.47055921052631433,-1.834046052631578,0.009539473684210265,2.7787828947368425,2.090953947368421,0.9366776315789451,-0.7437500000000004,0.28092105263157663,0.47582236842105274,-0.8185855263157897,-0.7072368421052637,1.6062500000000002,-2.6236842105263136
2010,138,1320,69,1242,67,N,0,2,9,1,8,-1,-2,-8,6.997767857142858,8.685267857142861,1.25,0.2388392857142847,2.8549107142857153,6.020089285714285,2.5334821428571423,2.5602678571428577,3.6361607142857153,2.078125,3.5758928571428577,3.28125,2.5133928571428577
2010,138,1388,75,1437,68,N,0,7,10,2,8,1,7,8,-0.46988095238095084,-0.8872619047619068,0.1592857142857147,-0.2714285714285687,-4.29797619047619,-5.568928571428572,-1.380119047619047,0.788214285714286,1.7140476190476175,-1.0032142857142858,-2.631785714285715,0.3930952380952375,-6.025476190476191
2010,138,1397,83,1325,68,N,0,15,6,14,-8,-1,-15,8,-1.162857142857142,-0.9360714285714238,1.6728571428571426,1.797500000000003,2.8728571428571428,2.036428571428573,0.027142857142855803,2.2096428571428532,0.8399999999999999,-0.6332142857142848,-0.3335714285714282,-0.9960714285714283,-2.1035714285714313
2010,138,1449,82,1307,64,N,0,18,11,3,8,-1,-18,-8,-3.357758620689655,-3.673850574712638,2.2040229885057476,4.831657088122604,-0.3156130268199213,0.39703065134099447,0.7423371647509587,0.7224616858237525,0.33357279693486674,-1.9034961685823752,-1.1599616858237551,0.07471264367816044,-3.6997126436781578
2010,139,1165,87,1458,69,N,0,18,12,4,8,1,18,8,3.7309782608695627,3.4523913043478274,2.3118478260869573,3.149673913043479,-0.8735869565217378,-1.6027173913043473,0.8589130434782604,0.7471739130434756,4.130869565217388,4.0089130434782625,0.9851086956521744,0.3780434782608695,3.1918478260869563
2010,139,1181,68,1143,53,N,0,15,1,8,-7,-1,-15,7,1.482158920539728,-0.7247376311844107,-0.9125187406296851,-2.3267616191904033,-1.5255622188905562,-1.4863568215892045,-2.3703148425787113,0.6111694152923519,1.3152923538230894,1.0259370314842577,-0.6515742128935536,-1.2480509745127435,-2.0005997001499267
2010,139,1277,85,1268,83,N,0,2,5,4,1,-1,-2,-1,1.4678030303030276,4.077651515151516,0.8693181818181817,1.0871212121212146,0.8333333333333321,0.1571969696969724,-1.0549242424242422,0.428030303030301,-0.704545454545455,-1.8920454545454533,1.1818181818181817,1.8276515151515147,-0.2613636363636367
2010,139,1326,75,1210,66,N,0,9,2,10,-8,-1,-9,8,0.7751322751322753,4.542328042328037,-0.6560846560846567,-2.106481481481481,1.1435185185185173,2.8617724867724874,4.939814814814815,2.654761904761905,0.507275132275133,4.158730158730158,0.46693121693121764,1.325396825396826,2.833994708994709
2010,139,1345,63,1401,61,N,1,2,4,5,-1,1,2,-1,-0.4656565656565661,0.6074074074074076,-1.0499999999999998,-1.9373737373737328,-2.7244107744107744,-5.334343434343435,-3.0299663299663298,-2.7700336700336727,1.2910774410774408,-1.7755892255892256,-0.24579124579124478,0.2932659932659929,-0.6774410774410811
2010,139,1393,87,1211,65,N,0,22,1,8,-7,-1,-22,7,-4.098095238095233,-3.826904761904764,-0.9392857142857141,-2.129999999999999,5.039999999999999,7.062619047619052,-1.998571428571429,2.5021428571428572,-5.388095238095236,-1.2440476190476168,-2.838571428571429,-1.550476190476191,2.6657142857142873
2010,139,1452,68,1281,59,N,0,9,2,10,-8,-1,-9,8,0.6946127946127945,2.2510101010101025,-0.2712121212121197,-1.5457912457912464,-0.32087542087542253,-2.1353535353535342,-3.0702020202020197,-0.4260942760942754,-1.5670033670033678,0.7065656565656564,5.509427609427611,0.5523569023569026,-0.20016835016835088
2010,139,1462,71,1338,68,N,0,3,6,3,3,-1,-3,-3,-3.9791666666666714,-6.958333333333343,-1.9375,-3.645833333333332,-2.229166666666666,-2.6875,0.2083333333333357,-2.75,1.208333333333334,-1.25,-1.791666666666666,0.5,-2.1041666666666643
2010,143,1139,63,1393,59,N,0,4,5,1,4,1,4,4,-7.303571428571427,-7.625,0.4464285714285712,3.4642857142857153,5.517857142857142,4.339285714285715,-3.892857142857144,-0.42857142857142705,-5.892857142857141,-1.428571428571427,-1.8035714285714288,-2.9821428571428577,4.25
2010,143,1243,101,1462,96,N,2,5,2,6,-4,1,5,-4,-1.3086904761904776,-0.8091666666666697,-0.4136904761904763,0.48785714285714477,2.8442857142857143,5.817619047619047,3.2338095238095264,-3.6746428571428567,0.46452380952381134,0.7589285714285712,0.2082142857142859,1.1352380952380954,3.391071428571429
2010,143,1246,62,1165,45,N,0,17,1,12,-11,-1,-17,11,1.171875,-1.3743750000000006,5.85125,8.419375000000002,-6.844374999999999,-10.115625,-3.4712500000000013,-4.092500000000001,4.448124999999997,-1.1806249999999991,0.32750000000000057,-3.19125,2.4499999999999993
2010,143,1452,69,1449,56,N,0,13,2,11,-9,-1,-13,9,1.5787037037037024,0.7638888888888857,-2.5,-5.983796296296298,3.2407407407407405,3.2361111111111143,-3.125,1.8078703703703738,-3.1782407407407423,1.4930555555555554,1.9629629629629637,-0.3287037037037033,2.0740740740740726
2010,144,1124,72,1388,49,N,0,23,3,10,-7,1,23,-7,0.3299999999999983,-1.722857142857137,-0.697976190476191,-2.350595238095238,1.4973809523809525,2.315952380952382,1.3979761904761894,0.08678571428571402,-1.6069047619047616,1.4317857142857164,1.2300000000000004,1.9194047619047625,2.019523809523811
2010,144,1181,70,1345,57,N,0,13,1,4,-3,1,13,-3,2.6149425287356323,4.403320561941257,2.432567049808429,4.027969348658999,2.647381864623245,1.5245210727969365,4.850830140485314,2.108556832694763,0.08825031928480165,0.8012771392081728,-0.06807151979565784,-0.0832694763729247,0.990293742017883
2010,144,1277,59,1320,52,N,0,7,5,9,-4,1,7,-4,6.377976190476193,6.836309523809533,-1.5625,-5.693452380952383,0.5684523809523832,3.014880952380949,3.7886904761904745,1.8154761904761934,5.339285714285715,3.0625,2.2946428571428577,0.604166666666667,0.7946428571428577
2010,144,1397,76,1326,73,N,0,3,6,2,4,-1,-3,-4,-0.1463227513227494,-5.062923280423277,1.2325132275132278,0.13969576719576793,-1.5528042328042329,-2.6801058201058225,-2.318624338624339,0.2763095238095232,0.10296296296296248,-1.2693253968253941,-0.7124074074074072,0.5130555555555554,-5.056613756613757
2010,145,1139,63,1243,56,N,0,7,5,2,3,1,7,3,-3.5692857142857157,-7.491428571428571,0.17857142857142794,1.3514285714285705,-1.326428571428572,-5.984285714285711,-6.781428571428574,1.076428571428572,-1.4942857142857147,-1.0892857142857135,-0.020714285714285907,-2.093571428571429,-3.114285714285714
2010,145,1452,73,1246,66,N,0,7,2,1,1,-1,-7,-1,-0.3431712962962976,-0.9600694444444429,-3.072916666666666,-4.502893518518519,2.961226851851851,3.071180555555557,-1.4548611111111107,4.877314814814817,-3.888310185185185,2.6267361111111107,1.456018518518519,2.7858796296296298,-1.7592592592592595
2010,146,1181,78,1124,71,N,0,7,1,3,-2,-1,-7,2,1.2017241379310342,-3.5980295566502463,-0.2883210180623976,-2.3230090311986835,-1.8329638752052553,-1.3130131362890012,-1.735816912972087,2.0923029556650263,0.5544745484400657,2.6690270935960605,-0.21896551724137936,2.5752668308702793,-0.5715106732348119
2010,146,1277,70,1397,69,N,0,1,5,6,-1,1,1,-1,0.8758333333333361,-1.6783333333333275,-0.9325000000000001,-4.106666666666666,0.15916666666666757,-0.38083333333333513,2.0408333333333317,1.7108333333333334,2.6400000000000006,1.0650000000000013,-0.8674999999999997,-0.938333333333333,-3.2375000000000007
2010,152,1139,52,1277,50,N,0,2,5,5,0,1,2,0,-4.502976190476193,-5.175595238095241,1.9732142857142856,6.193452380952383,4.2886904761904745,3.2708333333333357,-4.4851190476190474,-1.1190476190476204,-3.571428571428571,-1.4553571428571423,0.1875,-0.22916666666666696,2.1517857142857153
2010,152,1181,78,1452,57,N,0,21,1,2,-1,1,21,-1,0.2519795657726682,0.5107279693486646,-0.006321839080459135,-0.9961047254150728,2.262196679438059,0.3745210727969379,-1.4973180076628338,1.2492975734355056,-3.1265644955300136,-0.15613026819923448,1.4874840357598984,-0.24623243933588768,0.37177522349936254
2010,154,1181,61,1139,59,N,0,2,1,5,-4,-1,-2,4,-3.7804187192118235,-8.026600985221677,-0.8746305418719214,-0.058128078817730966,1.3575123152709345,1.6810344827586192,-5.078078817733992,0.40480295566502633,-0.6300492610837427,1.4993842364532028,0.6560344827586206,-1.2491379310344826,0.08325123152709324
2011,134,1155,70,1412,52,N,0,18,12,12,0,1,18,0,-0.7678571428571423,-1.1666666666666643,-0.7743506493506489,-3.1393398268398265,1.6574675324675319,3.025703463203463,0.4983766233766218,-0.7432359307359349,-0.7267316017316023,0.6133658008658003,2.8076298701298708,1.4388528138528134,1.1314935064935057
2011,134,1421,81,1114,77,N,1,4,16,16,0,-1,-4,0,-3.127262443438916,-3.1767533936651517,1.8016119909502262,1.963659502262443,-0.8491233031674223,-0.9693156108597307,-1.1189196832579178,-0.8168834841628936,-2.9623868778280524,-3.751555429864254,-3.253817873303168,-1.9926470588235294,0.9671945701357494
2011,135,1427,70,1106,61,N,0,9,16,16,0,-1,-9,0,-2.3949283559577665,-2.1392345399698343,-2.2994438159879333,-3.2910916289592755,-1.0112839366515836,2.2986708144796353,3.014253393665159,-1.306042609351433,-0.822841251885368,2.1071361236802417,0.5975018853695326,2.2214555052790343,2.544108220211161
2011,135,1433,59,1425,46,N,0,13,11,11,0,-1,-13,0,0.5596080121251745,-0.6273737703943709,-1.7281494249457632,-5.093695206395434,-2.5018351214003403,-1.52560254390918,-0.14092543611994302,2.367269458230556,-1.563486284882167,-0.40151267496805154,-2.265929150940593,-0.8574549020773277,-1.3069927783886612
2011,136,1139,60,1330,58,N,0,2,8,9,-1,1,2,-1,1.5917508417508444,2.0462962962962905,2.877104377104377,5.469696969696969,2.5218855218855207,1.8038720538720554,-3.7988215488215467,-0.9006734006734014,-1.6969696969696955,-0.5378787878787854,-0.3863636363636358,-2.6624579124579126,3.580808080808083
2011,136,1140,74,1459,66,N,0,8,3,14,-11,1,8,-11,0.30172413793103203,5.493226600985224,1.4669540229885065,7.825123152709358,1.5539819376026252,0.4380131362890012,0.5348932676518885,3.9936371100164223,-2.058292282430214,-0.5385878489326767,0.597495894909688,1.6504515599343184,-1.1746715927750415
2011,136,1153,78,1281,63,N,0,15,6,11,-5,1,15,-5,-4.917045454545452,-5.469090909090916,-0.5395454545454541,0.4574999999999996,-4.037272727272729,-2.87409090909091,2.1477272727272716,-0.5643181818181802,-2.1656818181818167,-0.7272727272727266,-2.1306818181818183,-1.2631818181818182,-3.066136363636364
2011,136,1163,81,1137,52,N,0,29,3,14,-11,-1,-29,11,-0.7783547008547025,-6.416132478632477,0.9874358974358977,-1.14628205128205,-0.8773717948717952,-2.0131837606837593,-6.885534188034187,-0.2596581196581198,2.270149572649572,-0.02824786324786288,-1.832628205128204,-2.1701282051282043,1.6027991452991444
2011,136,1196,79,1364,51,N,0,28,2,15,-13,1,28,-13,2.3111263736263723,4.5401785714285765,-1.0968406593406597,-1.9732142857142847,-1.8911401098901095,0.6892170329670328,4.586538461538462,0.4196428571428612,-0.7884615384615383,-1.646634615384615,-2.40728021978022,-0.5652472527472527,-4.403846153846155
2011,136,1211,86,1385,71,N,0,15,11,6,5,1,15,5,1.4935378631030822,1.2827028044419393,1.4661522052826408,3.300175669740886,0.9713909279126653,-0.271786184829665,0.5043603739255929,3.6331325679151796,2.4986824769433458,1.042944977727588,-1.5116067507371849,0.7697471610515088,0.10640567162306169
2011,136,1243,73,1429,68,N,0,5,5,12,-7,1,5,-7,0.3711822660098534,3.095238095238095,0.46059113300492616,1.536945812807879,2.3913793103448278,4.4550082101806225,3.162725779967161,-2.0481116584564845,-0.12807881773398933,2.7515599343185553,1.3606732348111654,0.6619868637110011,1.844499178981934
2011,136,1246,59,1343,57,N,0,2,4,13,-9,1,2,-9,2.5166666666666693,6.225000000000001,0.9866666666666664,1.3241666666666667,0.9749999999999996,1.2133333333333383,2.395833333333332,1.7291666666666643,-0.8591666666666669,-1.6999999999999993,-0.6558333333333337,2.4933333333333336,-0.5824999999999996
2011,136,1287,62,1257,61,N,0,1,13,4,9,-1,-1,-9,2.9971717171717174,4.875454545454545,2.071212121212122,4.53252525252525,-1.5724242424242423,-2.624141414141416,-2.619797979797978,-0.2986868686868718,4.933838383838385,-2.1021212121212116,1.1063636363636364,1.5129292929292926,-0.2097979797979832
2011,136,1338,74,1421,51,N,0,23,1,16,-15,1,23,-15,-0.677439458689463,-3.654789886039879,1.2066773504273502,0.14040242165242312,-1.4727207977208003,-0.3345797720797705,1.6352742165242162,0.33767806267806577,1.5615918803418811,-3.104237891737892,-3.9096866096866094,-1.1659722222222224,-0.8993767806267812
2011,136,1350,69,1435,66,N,0,3,12,5,7,1,3,7,-0.19513457556935876,0.26999079825166206,0.6813204508856687,-0.7895100069013097,-6.417345295606163,-6.837163561076604,-1.3709224752703033,-2.7942949160340476,1.4914768806073155,-2.008753163100991,1.0900621118012426,-0.7360593512767437,-0.07831838049229489
2011,136,1361,68,1294,50,N,0,18,2,15,-13,-1,-18,13,-2.8464912280701746,-6.703508771929819,2.2289473684210517,3.0701754385964897,6.303508771929824,5.827192982456143,-2.5271929824561425,-1.2114035087719301,-1.3684210526315788,3.592105263157894,-0.7280701754385976,-2.2763157894736845,5.65263157894737
2011,136,1396,66,1336,64,N,0,2,7,10,-3,-1,-2,3,-1.4468421052631584,-5.522406015037589,0.08646616541353414,0.5700000000000003,-1.9948120300751881,-3.869699248120302,-1.4157142857142837,-2.7908270676691735,-2.1679699248120308,-0.5406015037593992,-2.1399999999999997,-2.2810526315789477,-1.9870676691729336
2011,136,1417,78,1277,76,N,0,2,7,10,-3,-1,-2,3,-0.5878066378066364,0.7976911976911936,1.2926406926406928,2.7582251082251066,-2.0573593073593095,-2.8295093795093784,0.054545454545454675,-0.12243867243866902,0.9043290043290035,-1.9472582972582977,0.6848484848484846,-0.42987012987012996,0.6153679653679625
2011,136,1452,84,1155,76,N,0,8,5,12,-7,-1,-8,7,0.5230519480519469,0.2356060606060595,-0.1175324675324676,0.00952380952380949,-1.8834415584415591,-2.1117965367965397,-1.8425324675324681,1.26017316017316,-2.6335497835497836,1.3576839826839802,3.4201298701298697,0.26612554112554143,0.3974025974025963
2011,136,1458,72,1125,58,N,0,14,4,13,-9,-1,-14,9,3.3726449275362285,5.6068840579710155,1.194746376811593,4.226086956521737,3.73605072463768,6.43550724637681,1.5144927536231894,1.438586956521739,2.7990942028985515,7.192753623188406,6.044746376811594,-0.34293478260869525,7.180072463768113
2011,137,1112,77,1272,75,N,0,2,5,12,-7,1,2,-7,-0.3366137566137546,-2.364126984126983,1.7547089947089933,1.9868783068783031,2.618941798941801,2.050052910052912,-2.1372486772486763,0.873227513227512,-1.166031746031745,-2.7366137566137567,-3.8532275132275124,-2.655661375661375,-1.0379894179894151
2011,137,1181,87,1214,45,N,0,42,1,16,-15,1,42,-15,3.4333333333333336,2.9251811594202906,1.3527173913043473,3.764311594202894,1.4708333333333314,-2.0615942028985543,0.5704710144927532,0.07192028985507193,0.7688405797101456,-0.2925724637681135,-0.4923913043478265,-1.5989130434782606,-0.573007246376811
2011,137,1199,57,1401,50,N,0,7,10,7,3,1,7,3,1.8886645962732942,4.271169772256727,0.7058229813664596,2.5296325051759823,-3.1092391304347835,-3.234704968944097,0.02973602484471982,3.3058488612836427,0.21728778467909038,3.558229813664596,2.4303571428571438,4.2494565217391305,1.3402691511387133
2011,137,1206,61,1437,57,N,0,4,8,9,-1,1,4,-1,2.0335497835497804,0.6865634365634392,0.18040293040293065,-1.0381285381285394,-3.4978354978354957,-2.5145687645687644,-0.24583749583749537,-0.5621045621045617,0.5201465201465201,0.036796536796538604,-0.2249417249417247,-0.10273060273060297,-0.2718115218115216
2011,137,1228,73,1424,62,N,0,11,9,8,1,1,11,1,1.4685391363022902,0.2164304993252273,1.5716093117408905,0.441632928475034,-3.7260458839406194,-6.313006072874494,-1.668353576248311,1.1511470985155228,1.8421896086369767,-0.0805499325236152,-2.5922739541160613,1.4376686909581644,-1.2676282051282044
2011,137,1242,72,1131,53,N,0,19,1,16,-15,-1,-19,15,-4.860863095238095,-3.2402129120879124,1.6649496336996332,3.844551282051281,-1.9779075091575091,-4.070341117216117,0.787145146520146,1.4423076923076934,-5.141483516483516,-2.029990842490843,-2.45415521978022,0.16718177655677646,-1.5871680402930401
2011,137,1266,66,1462,55,N,0,11,11,6,5,1,11,5,2.7845238095238045,3.979761904761908,0.1845238095238093,-1.6636904761904763,1.1625000000000014,2.964880952380952,2.661309523809523,-0.11428571428571388,3.8845238095238095,-0.24464285714285694,1.3095238095238093,0.6327380952380954,-0.8732142857142904
2011,137,1276,75,1397,45,N,0,30,8,9,-1,1,30,-1,-1.6963562753036427,-4.419172932330831,2.8183921341816074,5.992192018507808,-5.249855407750145,-8.04930595720069,-5.894592249855407,-0.6720647773279396,0.07923655292076504,-3.015037593984962,-2.761711972238288,-1.5400520532099484,-2.7125506072874472
2011,137,1314,102,1254,87,N,0,15,2,15,-13,-1,-15,13,-0.09188034188034067,-1.8270248270248288,1.95099715099715,4.869922669922666,2.7406186406186386,5.697252747252747,0.4946886446886438,-0.30056980056979654,0.15404965404965232,0.24590964590964504,0.8695970695970683,-1.4888685388685392,1.4883190883190913
2011,137,1323,69,1103,56,N,0,13,2,15,-13,-1,-13,13,0.6891025641025657,4.030303030303031,0.6657925407925411,1.7645687645687644,-3.669871794871794,-5.224941724941726,-0.4061771561771561,-0.6448135198135212,-1.406177156177156,0.4574592074592072,1.4277389277389272,0.03059440559440585,2.2438811188811165
2011,137,1326,75,1427,46,N,0,29,1,16,-15,1,29,-15,1.2475961538461533,-3.32091346153846,-1.540865384615385,-4.454326923076923,0.34735576923077005,-0.7884615384615401,-0.8581730769230766,-1.5480769230769234,0.6586538461538467,-2.3233173076923066,1.0492788461538467,0.30889423076923084,-4.98076923076923
2011,137,1345,65,1389,43,N,0,22,3,14,-11,1,22,-11,3.908021978021978,4.965439560439563,0.5404945054945056,1.5502747252747255,0.05247252747252773,-2.303901098901097,-1.2288461538461526,-0.38565934065934115,3.347252747252746,-5.07368131868132,-1.7458791208791204,-0.6343406593406593,-0.7590659340659371
2011,137,1393,77,1232,60,N,0,17,3,14,-11,-1,-17,11,-4.043666859456334,-5.164835164835161,-0.09687680740312299,0.4200404858299578,2.3272122614227886,1.6376518218623488,-1.9261133603238854,0.7249855407750161,-3.253759398496241,1.9783111625216883,-2.0401966454598037,-2.5469924812030076,4.643001735106999
2011,137,1400,85,1324,81,N,0,4,4,13,-9,-1,-4,9,3.092923280423282,1.091600529100532,1.9388227513227507,5.866402116402117,-0.43551587301587347,-2.5333994708994716,-1.4900793650793656,0.3425925925925952,1.8303571428571423,3.5634920634920633,0.3475529100529098,0.46064814814814703,1.219246031746028
2011,137,1433,74,1207,56,N,0,18,11,6,5,-1,-18,-5,0.44970826275174147,-2.735017880670057,-1.2697534349708262,-2.825023527197441,-1.8851684547336731,-2.8269809900244667,-0.36047430830039495,2.110502540937322,0.12661396574440076,1.595605119518165,-2.3894880481837006,0.5699887069452285,0.12834556747600345
2011,137,1449,68,1208,65,N,0,3,7,10,-3,-1,-3,3,-3.9464144551101086,-7.032796913231699,-3.455495953322041,-8.936438923395444,-0.15693581780538324,-1.227780914737437,-1.2838509316770192,0.6193675889328105,-1.081912290607944,0.2874082439299812,0.017344249952945034,-0.3986918878223227,-3.5477696216826615
2011,138,1139,71,1338,70,N,0,1,8,1,7,1,1,7,-0.3526936026935985,3.651851851851845,1.1308080808080812,5.404882154882152,0.29410774410774465,-1.7887205387205398,-1.767340067340065,0.6437710437710429,-3.7080808080808065,-0.1286195286195273,0.6728956228956227,-1.6828282828282828,1.2678451178451198
2011,138,1140,89,1211,67,N,0,22,3,11,-8,1,22,-8,0.2389222055638811,4.718640679660169,1.5635723804764279,6.153194236215224,-0.3611319340329828,-0.06509245377311146,0.12685324004664267,-0.019906713310014368,-2.3134682658670673,-2.2703856405130782,0.6318299183741463,0.6285398967183076,-1.2583499916708298
2011,138,1163,69,1153,58,N,0,11,3,6,-3,-1,-11,3,-2.1633547008547005,-4.238632478632482,0.262435897435898,1.1562179487179485,-2.0048717948717965,-0.12568376068376352,-0.8630341880341881,-3.7521581196581195,0.525149572649573,-0.313247863247863,1.132371794871796,-1.6001282051282044,1.492799145299145
2011,138,1196,73,1417,65,N,0,8,2,7,-5,1,8,-5,1.1124375624375595,1.4494005994006045,0.8759740259740258,1.7069430569430555,-3.2899600399600413,-3.1268231768231765,1.477622377622378,-0.8306193806193747,-0.5947552447552447,-2.606293706293707,-0.7592907092907089,-1.7677822177822176,-3.00734265734266
2011,138,1246,71,1452,63,N,0,8,4,5,-1,1,8,-1,3.1522727272727273,3.8999999999999986,0.41999999999999993,-0.8697727272727285,-0.5090909090909097,-1.2120454545454535,-2.0511363636363633,3.0375000000000014,-2.6845454545454537,-1.2965909090909093,0.9945454545454542,2.0384090909090915,-1.1802272727272722
2011,138,1350,65,1287,48,N,0,17,12,13,-1,-1,-17,1,-1.2647907647907637,-1.4197931697931665,-1.7230639730639732,-1.4509379509379485,1.5030062530062533,2.5609668109668107,5.112073112073112,-0.1246993746993752,-2.7608225108225106,4.504449254449256,1.6056998556998554,-1.1421356421356417,2.661014911014913
2011,138,1361,71,1396,64,N,2,7,2,7,-5,1,7,-5,0.9947619047619014,2.435238095238091,-0.5642857142857141,-0.5061904761904756,-2.043809523809525,-2.77095238095238,3.036666666666669,0.4066666666666663,-1.6871428571428577,0.23571428571428577,-0.1638095238095234,-0.49571428571428555,-3.6171428571428574
2011,138,1458,70,1243,65,N,0,5,4,5,-1,-1,-5,1,0.9369306418219452,2.285455486542439,-0.9897774327122155,-3.1441511387163565,4.486050724637682,10.522412008281572,3.9085403726708083,1.4683488612836442,0.4514751552795051,7.971325051759835,2.5626035196687367,1.3296842650103518,5.120548654244303
2011,139,1112,70,1400,69,N,0,1,5,4,1,1,1,1,-1.1428571428571423,-4.732804232804227,1.3015873015873005,4.145502645502642,0.20370370370370594,-1.8941798941798957,-3.875661375661375,-1.1164021164021136,-0.8809523809523796,1.9179894179894177,-0.6587301587301582,-2.060846560846561,1.947089947089946
2011,139,1181,73,1276,71,N,0,2,1,8,-7,1,2,-7,2.590215924426449,7.045175438596495,-0.6338056680161941,0.6294871794871781,6.05762483130904,6.883265856950064,4.4633265856950075,1.5396086369770607,-1.2360661268556008,1.7850877192982466,2.073178137651821,2.4580971659919033,2.0186909581646404
2011,139,1199,71,1323,57,N,0,14,10,2,8,1,14,8,0.2879120879120869,2.247619047619054,-1.2386446886446887,-1.97893772893773,-3.111538461538462,-2.839010989010987,1.7446886446886456,1.213736263736262,-3.0505494505494504,4.716117216117217,3.8069597069597076,2.369230769230769,2.6175824175824154
2011,139,1242,73,1228,59,N,0,14,1,9,-8,-1,-14,8,-0.40125253036437414,-0.8200278340081013,0.7903593117408905,-0.07920040485829816,-4.361462550607287,-7.578631072874494,-0.9443952429149789,2.067813765182187,1.0713562753036427,-1.497216599190283,-2.2849822874493935,1.099127024291498,-2.08533653846154
2011,139,1266,66,1393,62,N,0,4,11,3,8,1,4,8,-0.17884615384615543,-1.503296703296698,-1.5384615384615383,-3.592032967032969,5.507967032967034,6.720604395604397,-0.5500000000000007,-0.15137362637362628,-0.34670329670329814,-0.5543956043956051,-0.9601648351648358,-3.3395604395604392,1.1247252747252716
2011,139,1314,86,1449,83,N,0,3,2,7,-5,1,3,-5,-2.140969899665553,-1.174988055422837,-3.796488294314381,-8.691017677974198,1.736837075967511,2.8853559483994253,0.702412804586718,2.689297658862877,-2.2239369326325846,1.5231724796942174,-0.729741997133301,-0.5126612517916858,-2.919397993311037
2011,139,1326,98,1206,66,N,0,32,1,8,-7,-1,-32,7,1.09375,4.806490384615387,0.8798076923076925,2.477564102564102,-2.880208333333332,-1.2636217948717956,2.6274038461538467,1.063301282051281,0.396634615384615,0.40104166666666785,-1.9763621794871797,0.8737980769230766,3.0857371794871824
2011,139,1433,94,1345,76,N,0,18,11,3,8,-1,-18,-8,0.9392320722755514,2.0187916431394655,-1.6335629587803497,-4.222642574816486,-1.2946922642574812,-1.595076228119705,-0.1604743083003939,2.761931112365893,0.6789949181253512,-1.8296329757199317,-2.377583286278938,0.03427442123094293,0.09977413890457143
2011,143,1112,93,1181,77,N,0,16,5,1,4,1,16,4,-1.2177248677248684,-5.514682539682539,-0.021957671957672176,-3.6986772486772495,0.6544973544973587,1.9100529100529116,-2.391137566137566,-0.8367724867724853,0.5678571428571431,0.9378306878306866,-2.182671957671957,-1.9367724867724867,1.0653439153439166
2011,143,1139,61,1458,54,N,0,7,8,4,4,1,7,4,1.179210584101888,2.07910628019323,-0.2938899868247695,-1.6069938515590714,4.237565876152832,7.812527448397015,0.525856389986826,3.1777283706631536,-0.5312088274044768,4.732652613087397,2.4611605182257357,-1.5729852876592005,4.060880544576197
2011,143,1163,74,1361,67,N,0,7,3,2,1,1,7,1,0.31752136752136906,1.161965811965814,0.45256410256410184,0.9846153846153847,2.6615384615384627,2.077350427350428,0.2713675213675195,0.0029914529914520926,0.027350427350427253,0.6132478632478637,-0.12820512820512953,1.055128205128204,2.454700854700855
2011,143,1196,83,1140,74,N,1,9,2,3,-1,-1,-9,1,0.46655930276619983,4.02207275483137,1.3121921182266014,5.1918813944676,4.524677908298598,3.3821523304281946,-1.7334217506631298,0.679992421371729,-0.8806366047745371,-1.0958222811671092,2.5059208033345968,0.44074460022735895,2.733753315649869
2011,144,1242,77,1350,57,N,0,20,1,12,-11,1,20,-11,1.8846726190476204,2.2037863756613802,-1.9386574074074074,-2.316468253968253,4.590443121693122,6.4055059523809526,2.2694279100529116,-0.6600529100529116,0.8313492063492056,3.285383597883598,1.4486607142857144,-0.5176091269841265,3.144758597883598
2011,144,1246,62,1326,60,N,0,2,4,1,3,1,2,3,1.6937500000000014,7.896875000000001,1.5075000000000003,3.532499999999999,-1.8218750000000004,-1.4012499999999974,2.71875,2.71875,-1.098749999999999,-0.5281249999999993,-2.306875,3.519375,2.4487500000000004
2011,144,1314,81,1266,63,N,0,18,2,11,-9,-1,-18,9,-0.36291208791208973,-5.201098901098902,0.7912087912087911,0.5700549450549435,2.021703296703297,1.679395604395605,-2.0719780219780226,-3.7832417582417577,1.5736263736263716,-2.796153846153846,1.1826923076923066,-1.0923076923076929,-0.372527472527473
2011,144,1433,72,1199,71,N,1,1,11,10,1,-1,-1,-1,0.1806606437041225,0.4554583098061329,-1.8364201016374926,-3.6845473367212485,-1.9375494071146253,-0.5936476566911324,1.9252399774138915,4.408121588556369,-1.4329098437794094,4.564652738565783,0.243845285149634,1.8628458498023712,0.9450122341426663
2011,145,1139,74,1196,71,N,1,3,8,2,6,1,3,6,-1.2619325119325069,0.22130647130646253,1.3982683982683985,3.3622488622488618,2.729353979353979,1.8485403485403502,-2.120046620046619,-0.25069375069375255,-1.2931235431235422,-0.47804972804972756,1.0022200022200023,-2.05999555999556,4.7987567987568
2011,145,1163,65,1112,63,N,0,2,3,5,-2,-1,-2,2,-0.7352462352462368,-5.934981684981679,1.2254782254782253,1.2833740333740309,2.3929588929588945,3.8160358160358143,-4.587505087505086,-0.5230972730972709,-0.3678266178266174,0.9912494912494907,-1.6628001628001616,-2.691900691900691,3.227309727309727
2011,146,1246,76,1314,69,N,0,7,4,2,2,1,7,2,-0.13076923076922853,-2.6760989010989036,2.646923076923077,4.031126373626371,-0.7640109890109894,-3.1852472527472493,-2.084478021978022,-2.177884615384613,-1.5778021978021979,-3.8943681318681307,-0.27373626373626436,1.6373351648351644,-0.32288461538461277
2011,146,1433,71,1242,61,N,0,10,11,1,10,-1,-10,-10,2.6391427865612656,1.9526309288537504,-1.8533843873517784,-4.556571146245059,1.431200592885375,3.352334486166008,0.8989006916996054,1.303359683794465,1.5182806324110665,2.3950098814229257,-0.5146368577075098,-0.12777915019762842,1.3037919960474298
2011,152,1139,70,1433,62,N,0,8,8,11,-3,1,8,-3,0.44675010979359087,1.0133948177426362,-0.6024374176548086,-2.0521519543258684,0.6972990777338595,1.1845630215195442,0.8425559947299099,2.9675010979358802,-1.803689064558629,0.36407553798858316,-2.524264382960035,-2.2422046552481336,1.421058410188845
2011,152,1163,56,1246,55,N,0,1,3,4,-1,1,1,-1,-1.1491452991452995,1.5036324786324755,-0.9674358974358981,0.14378205128205224,-0.43012820512820404,-1.056816239316241,2.5005341880341874,-0.5678418803418808,0.5573504273504266,1.125747863247863,0.7151282051282042,-1.0173717948717957,-0.4377991452991452
2011,154,1163,53,1139,41,N,0,12,3,8,-5,-1,-12,5,-1.1276223776223766,-4.339743589743591,1.1171328671328675,1.6406371406371392,0.9399766899766888,2.024669774669775,-3.385003885003883,-0.455516705516704,-0.8743201243201231,0.29331779331779373,-0.4803807303807295,-3.7101787101787096,3.30944055944056
2012,134,1140,78,1233,72,N,0,6,14,14,0,1,6,0,-2.1706677018633513,0.07487577639751208,-1.4751708074534164,-0.03518633540372562,0.6302018633540385,1.7945186335403704,1.2255434782608692,1.2955590062111781,-2.933074534161488,0.6482919254658377,1.581009316770186,1.8767236024844713,1.473835403726703
2012,134,1443,59,1290,58,N,0,1,16,16,0,-1,-1,0,1.6162698412698404,4.8769841269841265,1.6464285714285722,4.296428571428571,-2.763888888888891,-2.697222222222223,0.41904761904761934,-0.13214285714285978,1.8769841269841265,-0.8039682539682538,3.007142857142857,-1.8317460317460323,1.1396825396825427
2012,135,1378,65,1143,54,N,0,11,12,12,0,-1,-11,0,5.07790710751237,7.260768106162843,-0.017347053531263867,-2.1576417004048594,2.8414304993252344,2.856584570400358,0.1859255510571316,0.6395355375618514,4.051535087719298,-1.4345760233918128,-0.742690058479532,-0.34694107062528134,-0.36066126855600444
2012,135,1436,71,1249,59,N,0,12,16,16,0,-1,-12,0,1.6721249764728014,7.213626952757394,-1.118953510257858,-1.9181253529079605,3.441746659137962,5.041313758705062,3.9573687182382837,1.30942970073405,-0.7136269527573873,0.029173724825898972,1.7731978166760767,1.5773574251835125,0.5778279691323149
2012,136,1124,68,1355,60,N,0,8,3,14,-11,1,8,-11,0.5374725274725272,0.46000000000000796,-2.260989010989011,-4.586483516483515,-0.39890109890109926,-1.7458241758241755,1.4687912087912078,-0.7215384615384615,1.0849450549450559,2.5101098901098915,1.777802197802198,2.3418681318681323,1.9470329670329676
2012,136,1160,68,1424,64,N,0,4,11,6,5,1,4,5,-2.7215909090909065,-4.746753246753244,-2.3398268398268396,-5.38365800865801,0.5833333333333321,1.4724025974025956,-0.8365800865800885,-0.7586580086580099,-4.740800865800866,-0.2058982683982684,-1.07034632034632,-1.1444805194805188,-0.055735930735931305
2012,136,1211,77,1452,54,N,0,23,7,10,-3,1,23,-3,-0.4957624831309104,-5.104507422402158,0.9088798920377865,-0.8487584345479071,2.3419433198380553,1.7943049932523643,-4.915330634278003,2.1109581646423763,-1.0677732793522274,1.6500539811066144,0.18304993252361612,0.7306072874493923,-0.4147098515519545
2012,136,1231,79,1308,66,N,0,13,4,13,-9,1,13,-9,-0.5088888888888867,-4.718333333333341,1.4355555555555553,0.15083333333333115,-2.2394444444444446,-6.839722222222221,-4.182222222222222,-0.9836111111111165,-1.1436111111111096,-1.405833333333332,-1.767777777777778,-0.9811111111111113,-1.1183333333333358
2012,136,1235,77,1163,64,N,0,13,8,9,-1,-1,-13,1,0.342307692307692,-0.5840909090909037,-3.2288461538461544,-6.808041958041958,-1.247727272727273,-1.484965034965036,1.1680069930069905,-0.16608391608392026,-0.7791958041958047,-0.0047202797202814395,-0.2465034965034958,4.037237762237762,-1.7930069930069905
2012,136,1243,70,1379,64,N,0,6,8,9,-1,1,6,-1,0.9486024844720475,-2.8792184265010263,-0.5907867494824028,-1.1004399585921334,-0.5806418219461698,0.5762163561076576,0.5777432712215322,0.7343944099378845,4.162370600414079,4.1949016563147,0.2670548654244307,2.121946169772257,0.7289078674948222
2012,136,1246,81,1443,66,N,0,15,1,16,-15,1,15,-15,4.976388888888888,2.6909722222222214,-0.7114583333333329,-1.8270833333333343,-1.9097222222222232,-2.2024305555555586,0.05000000000000071,0.5010416666666657,0.8420138888888893,-3.1871527777777775,1.5927083333333334,4.081944444444444,-3.68472222222222
2012,136,1257,69,1172,62,N,0,7,4,13,-9,-1,-7,9,2.495955433455432,2.3627136752136693,2.4693986568986563,4.536019536019534,2.6359126984126995,0.49427655677655835,-0.9086538461538467,0.5575396825396837,1.0025183150183157,-1.9482600732600748,-4.022741147741147,-1.8638583638583635,2.608363858363859
2012,136,1266,88,1140,68,N,0,20,3,14,-11,-1,-20,11,1.7493322981366468,1.7263043478260869,0.2562577639751549,1.2705279503105622,-0.4040838509316771,-0.3683385093167715,-0.7715993788819873,1.6355590062111816,-0.04736024844720532,-0.7345652173913049,-0.31327639751552816,1.1510093167701858,1.1938354037267054
2012,136,1293,58,1161,41,N,0,17,6,11,-5,-1,-17,5,-0.09957912457912599,0.40782828282828376,-2.6871212121212116,-5.605218855218856,0.8686026936026963,-1.008838383838384,-0.5752525252525267,-1.774831649831647,-0.9183501683501696,-3.5164983164983177,-2.9071548821548827,-1.8030303030303028,-1.6844276094276083
2012,136,1307,75,1253,68,N,0,7,5,12,-7,-1,-7,7,1.8628762541806054,-0.08556298773689974,-1.3479654403567451,-2.9173634336677807,1.4319258639910828,3.285604793756967,-1.7325111482720175,-1.1007525083612073,-1.4460702341137122,-0.5130295429208473,0.6593506131549605,-0.3062290969899668,-1.7578037904124848
2012,136,1326,78,1259,59,N,0,19,2,15,-13,-1,-19,13,-3.294312169312171,-1.3799603174603163,0.31878306878306883,0.6078042328042326,2.1286375661375665,2.726190476190478,0.8078703703703702,-2.2334656084656075,-1.3955026455026438,0.49371693121693205,0.6286375661375665,1.3191137566137567,3.8009259259259274
2012,136,1393,72,1421,65,N,0,7,1,16,-15,1,7,-15,-0.6984126984126995,1.682155657962106,1.3822324628776235,2.5875576036866335,-7.014592933947771,-6.917178699436761,2.013568868407578,-1.7663850486431123,0.7375832053251408,-2.544034818228365,1.3701996927803375,3.2012288786482337,-1.6952124935995911
2012,136,1433,62,1455,59,N,0,3,12,5,7,1,3,7,-4.446062271062274,-3.7881868131868117,0.5228937728937719,1.7016483516483518,-0.9077838827838818,-0.13424908424908466,-0.4870879120879117,-5.686538461538461,-1.4155677655677668,-1.452106227106226,2.903937728937728,-0.502014652014652,-0.4755494505494511
2012,136,1435,79,1217,70,N,0,9,5,12,-7,-1,-9,7,-3.1625000000000014,-6.203333333333333,-2.7008333333333336,-4.285833333333336,-0.6274999999999995,-2.0458333333333343,-1.2774999999999999,-1.3041666666666671,0.42333333333333556,-0.5916666666666686,-0.21916666666666718,0.12333333333333307,-0.5883333333333347
2012,136,1458,73,1285,49,N,0,24,4,13,-9,-1,-24,9,2.0353260869565233,0.825785024154591,-1.0471014492753623,-4.858695652173914,3.6400966183574894,6.017512077294686,-0.47463768115941996,0.4770531400966149,2.1307367149758445,3.1887077294685984,1.033514492753623,0.16394927536231885,4.896135265700483
2012,137,1153,65,1400,59,N,0,6,6,11,-5,1,6,-5,-0.5612179487179496,3.3599358974359035,0.6804487179487175,2.7631410256410227,-7.065064102564104,-7.268910256410258,0.45288461538461533,0.10608974358974166,0.12724358974358907,-2.3432692307692307,0.9394230769230774,0.745833333333334,-4.8189102564102555
2012,137,1166,58,1104,57,N,0,1,8,9,-1,-1,-1,1,-2.7650432900432875,-3.415909090909082,-3.633766233766233,-5.460714285714285,-1.308225108225109,-1.153896103896102,0.6971861471861462,-1.2034632034632047,-3.432142857142857,0.8088744588744579,2.449134199134199,1.5813852813852818,0.6949134199134228
2012,137,1196,71,1438,45,N,0,26,7,10,-3,1,26,-3,3.791677646025473,7.916842336407555,4.9053798858146695,10.365129556433901,0.6548967940272288,1.0282169521299984,3.2770311813790087,-0.4652832674571812,2.2760210803689063,-0.5413702239789195,-0.26559068950373366,0.7268115942028981,0.2273166447079511
2012,137,1199,66,1382,63,N,0,3,3,14,-11,1,3,-11,1.0273989898989875,3.5669191919191974,0.546843434343435,1.6742424242424256,-3.5070707070707083,-3.024621212121211,0.6958333333333329,0.7944444444444443,-1.7502525252525256,1.5242424242424235,1.7315656565656568,1.6513888888888895,1.0815656565656546
2012,137,1207,74,1125,59,N,0,15,3,14,-11,-1,-15,11,2.7666083916083934,3.82317682317683,3.3203671328671334,7.134802697302698,3.13417832167832,2.5769855144855143,-0.4443681318681314,-0.3238011988011955,3.5624375624375624,0.1480394605394615,1.215846653346654,-2.9615384615384617,1.1665834165834177
2012,137,1242,65,1178,50,N,0,15,2,15,-13,-1,-15,13,-1.7650284900284916,-0.2878205128205096,-1.0172364672364669,-0.9921652421652407,2.1254273504273513,1.5940170940170972,0.849002849002849,-3.2506410256410234,-1.9306267806267812,-0.8203703703703695,-0.3063390313390313,-0.5057692307692303,0.08860398860398888
2012,137,1250,75,1181,70,N,0,5,15,2,13,-1,-5,-13,-0.17132275132275154,-2.2797354497354547,0.4878835978835978,-0.5535449735449731,-0.7511640211640191,1.5026455026455068,0.24835978835978878,-0.5816931216931245,-0.42915343915344195,0.552010582010583,-1.087936507936508,1.1412169312169311,-1.2917460317460332
2012,137,1277,89,1254,67,N,0,22,1,16,-15,-1,-22,15,1.221626984126985,1.253968253968253,0.961666666666666,3.1369973544973533,6.245701058201059,8.179312169312169,-0.6644841269841262,0.5953042328042351,0.23150793650793666,3.5588492063492048,-0.65542328042328,-0.8716005291005295,-1.8524603174603165
2012,137,1301,79,1361,65,N,0,14,11,6,5,1,14,5,2.036525974025974,1.462662337662337,-0.2981601731601735,-2.17478354978355,0.31791125541125353,0.8814935064935057,1.5984848484848477,-1.3739177489177479,3.871212121212121,-0.05681818181818343,1.907738095238095,1.8119588744588744,0.40503246753246813
2012,137,1313,86,1281,84,N,0,2,15,2,13,-1,-2,-13,2.8249999999999957,2.7041666666666657,2.187500000000001,3.895833333333332,1.9541666666666657,-1.5500000000000043,-1.5583333333333336,-2.366666666666667,3.5999999999999996,-4.6083333333333325,1.6624999999999996,-2.0166666666666666,-2.7958333333333307
2012,137,1314,77,1436,58,N,0,19,1,16,-15,1,19,-15,5.754913452364729,11.783876243696326,-0.08014174730816404,-0.4941665530870907,2.9252964426877455,5.500845032029439,4.602330652855391,3.5669756031075366,3.119258552541911,-0.31604197901049425,0.04944800327109178,2.5651765026577618,-0.9418018263595478
2012,137,1325,65,1276,60,N,0,5,13,4,9,-1,-5,-9,0.5630408239103915,-3.8059537081276176,1.3168763603546214,1.6072092159048665,-4.547154536284971,-7.319119286510592,-3.7408823060996976,1.1359425598556,0.14321548017200136,-2.703017996496257,-4.878483835005573,-0.5799888517279825,-4.694988586292936
2012,137,1345,72,1388,69,N,0,3,10,7,3,1,3,3,1.0528571428571425,4.647380952380949,1.7923809523809524,1.1154761904761905,-0.7630952380952376,0.9873809523809527,0.4435714285714276,-1.4354761904761872,-0.3430952380952377,-3.209761904761905,0.7042857142857146,0.5683333333333334,1.519047619047619
2012,137,1378,58,1396,44,N,0,14,12,5,7,1,14,7,-5.956875361480623,-8.55045064584538,-2.511422787738577,-2.9375963948332355,-2.2580971659919022,-3.179005205320994,0.09780460767302834,-0.305210140736456,-3.9384398496240607,1.5169172932330834,-1.8178258145363406,-0.46655099286678237,-3.3804101600154226
2012,137,1387,61,1272,54,N,0,7,9,8,1,-1,-7,-1,2.221382783882781,-0.1025641025641022,-1.4134615384615383,-4.988782051282049,3.1112637362637354,3.696199633699635,-0.9040750915750912,2.536401098901102,0.6318681318681314,1.624771062271062,0.6728479853479854,2.703754578754579,1.385531135531135
2012,137,1462,67,1323,63,N,0,4,10,7,3,-1,-4,-3,-2.5156926406926416,-2.2543290043290014,0.9507575757575744,5.379329004329001,-1.7835497835497822,-2.5519480519480524,-0.18939393939394122,-2.5984848484848477,0.13690476190476275,-2.6120129870129887,-0.704545454545455,-0.3322510822510818,-4.8225108225108215
2012,138,1124,80,1160,63,N,0,17,3,11,-8,1,17,-8,3.257992007992005,5.270562770562776,0.6026473526473533,1.2659840159840172,-0.31318681318681385,-3.070845820845822,2.914418914418915,-2.000499500499501,3.1707459207459205,1.0156510156510166,1.756243756243756,0.734681984681985,0.8263403263403255
2012,138,1231,63,1433,61,N,0,2,4,12,-8,1,2,-8,3.3145238095238128,-3.8314285714285745,-1.1140476190476187,-7.423571428571432,2.895476190476188,2.1205952380952375,-1.7546428571428585,1.9399999999999977,0.5984523809523825,1.5584523809523816,-3.80547619047619,-0.6170238095238094,-1.0171428571428578
2012,138,1246,87,1235,71,N,0,16,1,8,-7,-1,-16,7,-2.4375,-1.0596590909090935,3.578125,6.921022727272728,-0.13977272727272627,-0.22585227272727337,-1.2045454545454533,1.2701704545454575,2.124147727272728,0.5775568181818187,-1.2821022727272728,-5.5420454545454545,0.5170454545454533
2012,138,1257,59,1307,56,N,0,3,4,5,-1,1,3,-1,-0.15598290598290276,1.8696581196581263,-2.264957264957265,-1.7072649572649539,-1.6517094017094003,-0.6858974358974379,0.37179487179487225,-0.5470085470085486,-2.532051282051283,0.16025641025641235,3.034188034188033,1.4764957264957257,-0.4572649572649574
2012,138,1266,62,1293,53,N,0,9,3,6,-3,1,9,-3,1.4395767195767206,7.595555555555556,-3.0723809523809518,-2.8456084656084677,0.3538624338624352,0.08603174603174679,3.608253968253967,-1.0121693121693127,2.597883597883598,-1.6674074074074081,0.5529100529100521,-0.8095238095238093,-1.9813756613756617
2012,138,1326,73,1211,66,N,0,7,2,7,-5,-1,-7,5,-1.129312169312172,-3.324126984126977,1.6821164021164021,2.1694708994709,2.746137566137566,3.356190476190477,-1.822962962962965,1.4782010582010585,0.2678306878306884,2.187883597883598,-0.2271957671957674,0.603280423280423,-0.04074074074074119
2012,138,1393,75,1243,59,N,0,16,1,8,-7,-1,-16,7,0.17142857142857082,-0.8305683563748048,-2.3996927803379418,-4.939938556067588,2.8169738863287233,4.127496159754223,1.3642089093701983,2.0465437788018406,-0.7129800307219671,3.471812596006144,-3.020199692780338,-0.4250384024577576,3.5245775729646667
2012,138,1458,60,1435,57,N,0,3,4,5,-1,-1,-3,1,2.6750000000000007,1.0819444444444457,1.3708333333333336,0.5625,2.740277777777779,5.434722222222224,0.4375,0.4736111111111114,1.9263888888888872,4.159722222222223,0.5750000000000002,0.6791666666666671,0.7472222222222236
2012,139,1153,62,1199,56,N,0,6,6,3,3,1,6,3,-0.37777777777777644,4.173611111111114,0.6944444444444438,2.6625000000000014,-1.9819444444444443,-1.4916666666666707,2.166666666666668,-2.2152777777777786,0.968055555555555,-5.695833333333333,0.10138888888888964,-1.3055555555555554,-4.281944444444445
2012,139,1196,84,1313,50,N,0,34,7,15,-8,1,34,-8,2.3775362318840543,2.686413043478261,3.7469202898550744,6.657427536231882,-1.4896739130434788,-4.523550724637683,-0.005797101449275033,-1.0637681159420325,2.469202898550723,-3.7648550724637673,-0.49728260869565233,-0.981521739130435,-3.0106884057970973
2012,139,1242,63,1345,60,N,0,3,2,10,-8,1,3,-8,0.8664021164021172,-2.9107142857142847,-2.6005291005291014,-5.611772486772487,2.724206349206348,2.6170634920634903,-0.22949735449735265,3.648809523809522,1.0667989417989414,5.150132275132275,0.9708994708994707,1.7916666666666665,1.084656084656082
2012,139,1277,65,1387,61,N,0,4,1,9,-8,1,4,-8,0.8045634920634903,0.5376984126984183,-1.416666666666666,-4.833664021164019,0.12037037037037024,0.4259259259259238,2.0257936507936503,3.793981481481481,0.47420634920634797,2.504960317460318,0.054232804232803744,1.463624338624339,0.47222222222222143
2012,139,1301,66,1207,63,N,0,3,11,3,8,-1,-3,-8,-2.4242424242424256,-4.1287878787878824,0.020833333333333925,1.1571969696969688,-0.8731060606060588,-1.1155303030303045,-0.7026515151515156,-0.446969696969699,-2.3484848484848477,-0.1837121212121211,-0.7556818181818183,0.7803030303030303,0.6401515151515156
2012,139,1314,87,1166,73,N,0,14,1,8,-7,-1,-14,7,-2.6294334975369473,-8.961699507389156,2.5798029556650244,4.952339901477831,-2.7142857142857117,-5.426847290640396,-5.435221674876846,-1.7640394088669957,0.042980295566502846,0.13374384236453274,-1.5219211822660101,-2.670935960591133,1.4048029556650228
2012,139,1325,62,1378,56,N,0,6,13,12,1,1,6,1,2.354540196645459,8.346009253903986,2.211972238288027,7.097165991902834,2.8185367264314625,4.76417004048583,2.2151532677848476,-2.7630133024869856,1.0215442452284567,-0.2916425679583572,4.022267206477732,-1.0435222672064777,5.217177559282824
2012,139,1462,70,1250,58,N,0,12,10,15,-5,-1,-12,5,0.9140476190476186,4.341904761904765,2.0445238095238087,7.5145238095238085,1.1704761904761902,-0.8214285714285765,1.1590476190476178,-1.9923809523809517,-0.7302380952380929,-1.3450000000000006,1.3657142857142857,-0.8766666666666665,0.307619047619049
2012,143,1196,68,1266,58,N,0,10,7,3,4,1,10,4,0.41944099378881816,-1.1660869565217382,3.881801242236026,7.486832298136644,-2.5078881987577653,-4.012360248447205,-1.0862732919254636,-0.20900621118012452,-1.346273291925467,-2.7965217391304353,-2.5062111801242235,0.5363354037267078,-2.1936645962732904
2012,143,1257,57,1277,44,N,0,13,4,1,3,1,13,3,-1.3064713064713054,1.8287545787545838,0.08119658119658091,3.9613349613349627,0.08597883597883715,0.8744403744403755,0.46916971916972017,-1.0449735449735442,-0.8070818070818078,0.648656898656899,2.2601750101750095,0.6204721204721197,-0.22344322344322265
2012,143,1326,81,1153,66,N,0,15,2,6,-4,-1,-15,4,-1.581812169312169,3.7033730158730265,2.089616402116402,5.603637566137566,-3.554695767195767,-3.3279761904761926,1.6412037037037024,-1.2542989417989432,-0.35800264550264593,-1.8479497354497365,0.9869708994708999,1.6941137566137572,-0.9532407407407426
2012,143,1393,64,1458,63,N,0,1,1,4,-3,1,1,-3,2.9375,4.149417562724018,1.080645161290322,0.43279569892472836,0.8584229390681024,3.231630824372761,2.85483870967742,-2.8378136200716852,4.377464157706093,1.9688620071684593,3.968413978494623,1.73991935483871,1.340501792114697
2012,144,1124,75,1462,70,N,0,5,3,10,-7,1,5,-7,1.1286630036630036,1.7619047619047663,1.1378205128205128,3.310897435897438,-1.051282051282051,-3.0329670329670364,1.8278388278388267,-2.842490842490843,1.1918498168498175,0.9079670329670328,1.7692307692307692,0.322344322344323,-0.6996336996337007
2012,144,1242,60,1301,57,N,0,3,2,11,-9,1,3,-9,-0.7445286195286194,-2.575757575757578,0.17382154882154843,1.3665824915824896,1.1414141414141419,1.4141414141414117,-1.1910774410774412,0.3977272727272698,-1.167508417508417,0.5105218855218858,0.5601851851851851,1.0303030303030303,1.4802188552188547
2012,144,1246,102,1231,90,N,0,12,1,4,-3,-1,-12,3,-1.8074999999999974,-4.603750000000005,1.083125,-1.651250000000001,2.7674999999999983,1.4293750000000003,-2.022500000000001,-0.6693750000000023,0.26437500000000114,1.1618750000000002,-1.8493750000000002,-5.245,1.5274999999999999
2012,144,1314,73,1325,65,N,1,8,1,13,-12,1,8,-12,5.69784009094354,7.6191170898067355,-1.701780977643046,-7.326790450928382,2.389560439560439,3.6059681697612724,2.8192876089427816,6.552500947328532,3.5292724516862446,-1.8161614247821145,-3.6676392572944287,2.571485411140583,-4.460022735884806
2012,145,1257,72,1196,68,N,0,4,4,7,-3,-1,-4,3,2.5014678558156795,0.2991267186919302,4.061557041991826,6.071423262727606,-0.8299516908212574,-2.520345596432552,-1.6852842809364539,-1.2026570048309182,1.2544593088071352,-2.9988294314381285,-2.975380899293942,-1.256094388703084,-2.2505388331475267
2012,145,1326,77,1393,70,N,0,7,2,1,1,1,7,1,1.3359788359788354,-0.825012800819259,-3.649428230073391,-7.248933265062297,1.8532172725721097,1.6394009216589858,-0.5585424133811223,3.3907236729817356,-2.1555726233145602,1.0096432838368319,-2.7220515446321896,-2.600699778119133,-0.2942054958183995
2012,146,1242,80,1314,67,N,0,13,2,1,1,1,13,1,-2.9166028097062586,-9.155747126436772,0.3173690932311617,1.3381864623243906,-1.3388888888888886,-2.603831417624523,-4.239719029374202,-2.073563218390806,-1.3997445721583652,1.6755427841634738,1.4489782886334606,-0.013793103448275446,2.669220945083012
2012,146,1246,82,1124,70,N,0,12,1,3,-2,-1,-12,2,-1.0885989010989015,-0.3616071428571388,1.1742788461538467,1.184409340659343,0.37431318681318615,-1.5932348901098905,-0.005494505494505475,-1.6601991758241752,2.3518200549450547,1.8566277472527482,0.6598557692307692,-4.305631868131868,2.458104395604394
2012,152,1242,64,1326,62,N,0,2,2,2,0,1,2,0,-0.07671957671957585,-1.2341269841269806,0.92063492063492,1.436507936507935,1.4272486772486772,2.087301587301585,-1.2222222222222232,1.2248677248677247,1.3915343915343925,1.3849206349206344,0.8346560846560847,2.4232804232804233,2.796296296296294
2012,152,1246,69,1257,61,N,0,8,1,4,-3,1,8,-3,3.7280982905982896,0.6439636752136693,-0.49265491452991483,-2.7005876068376082,0.28472222222222143,0.2479967948717956,-0.5961538461538467,-0.23784722222222143,-0.8032852564102555,-2.5516826923076934,-1.9312232905982896,3.537927350427351,-2.6565170940170937
2012,154,1246,67,1242,59,N,0,8,1,2,-1,-1,-8,1,-1.1782407407407405,-2.3020833333333357,0.4299768518518512,-0.2025462962962976,1.5486111111111107,1.4913194444444429,-1.4259259259259256,0.8489583333333321,2.250578703703704,1.7297453703703702,0.3258101851851851,-3.1875,3.2662037037037024
2013,134,1299,73,1251,72,N,0,1,16,16,0,-1,-1,0,2.5493055555555557,1.2451388888888886,0.9298611111111104,-1.5166666666666657,1.4930555555555536,-0.65486111111111,-0.8152777777777782,1.1437500000000043,0.7055555555555557,-1.7444444444444454,-1.7416666666666663,-1.3708333333333327,-0.6152777777777771
2013,134,1388,67,1292,54,N,0,13,11,11,0,-1,-13,0,-1.9844322344322336,-0.11419413919414012,-3.895604395604396,-9.776739926739928,2.683241758241758,3.9828754578754584,2.2653846153846153,0.14075091575091747,-0.7254578754578773,2.0397435897435905,1.072344322344322,1.342948717948718,3.118498168498167
2013,135,1241,68,1254,55,N,0,13,16,16,0,1,13,0,-4.540384615384614,-2.9302197802197796,-1.4384615384615378,-1.7750000000000021,-3.4684065934065966,-5.251373626373628,-1.9054945054945058,-0.4733516483516489,-3.3596153846153847,-2.848076923076924,0.9857142857142858,1.1071428571428568,-0.3494505494505482
2013,135,1247,80,1129,71,N,0,9,13,13,0,-1,-9,0,-1.0435254803675846,-2.8833333333333258,0.31587301587301564,-1.1253968253968267,1.189974937343358,1.1985380116959057,-0.7893901420217215,1.6834586466165433,-1.2241436925647449,0.9549289891395158,-1.4383876357560572,-1.841269841269841,3.969047619047622
2013,136,1112,81,1125,64,N,0,17,6,11,-5,1,17,-5,-2.3204761904761924,-0.6888095238095246,-0.6646428571428569,-2.5096428571428575,3.5495238095238104,4.316309523809526,1.8165476190476184,1.855238095238093,-1.500357142857144,-0.9413095238095259,-2.222261904761904,1.5995238095238098,-2.405000000000001
2013,136,1139,68,1137,56,N,0,12,6,11,-5,-1,-12,5,0.5416666666666679,0.16138888888888658,-1.3697222222222223,-4.860833333333334,1.0629629629629633,-0.18064814814815122,-2.710925925925924,2.242592592592594,0.5693518518518523,-4.161388888888888,-1.9666666666666663,1.8795370370370375,-2.2588888888888867
2013,136,1143,64,1424,61,N,0,3,12,5,7,1,3,7,0.9513888888888893,0.17979797979797496,-2.659848484848485,-7.610606060606063,-1.0330808080808076,-1.7464646464646485,-0.34747474747474705,-1.594065656565661,-1.8078282828282841,-1.5429292929292924,-0.9118686868686883,-0.9608585858585847,-0.5337121212121225
2013,136,1161,84,1281,72,N,0,12,8,9,-1,1,12,-1,-2.172282608695653,-1.485326086956519,-0.9201086956521749,-2.992934782608698,1.469021739130433,3.3679347826086925,1.688586956521739,-1.9663043478260853,-1.4782608695652169,-2.721739130434784,-2.3847826086956516,-1.4749999999999996,0.8103260869565254
2013,136,1211,64,1380,58,N,0,6,1,16,-15,1,6,-15,3.93333333333333,0.02222222222221859,-0.9111111111111114,-1.6750000000000007,1.6305555555555564,0.7250000000000014,2.347222222222223,-1.9027777777777786,4.002777777777778,-0.08055555555555571,-0.4805555555555552,-1.216666666666666,-1.2611111111111128
2013,136,1217,68,1307,62,N,0,6,14,3,11,1,6,11,0.8448275862068968,-5.149233716475095,-0.32298850574712645,-3.7647509578544067,2.3477011494252853,2.4189655172413786,-1.975862068965517,-3.251724137931035,-1.7781609195402286,1.6865900383141774,0.684482758620689,0.3549808429118775,-0.5607279693486582
2013,136,1257,79,1299,48,N,0,31,1,16,-15,1,31,-15,5.148730842911874,7.693127394636015,-0.47789750957854515,-2.177873563218391,1.4686302681992345,1.59513888888889,2.9784003831417625,-0.557399425287354,3.642337164750959,-1.969157088122607,3.4738505747126442,-0.7550287356321834,-0.25464559386973207
2013,136,1266,59,1172,58,N,0,1,3,14,-11,-1,-1,11,-0.2011801242236011,1.255388198757764,3.064565217391305,5.957406832298137,1.8883695652173902,-0.05203416149068474,-2.283245341614906,-0.4079813664596301,0.16388198757763917,-3.2282608695652186,-0.6003881987577646,-0.7317546583850927,0.9029037267080753
2013,136,1272,54,1388,52,N,0,2,6,11,-5,1,2,-5,2.3679487179487175,2.051282051282044,-2.513461538461538,-8.416025641025643,0.2737179487179482,2.6102564102564116,1.1987179487179471,0.05384615384615543,1.9685897435897424,3.889743589743592,2.9794871794871804,3.5262820512820516,3.183974358974357
2013,136,1276,71,1355,56,N,0,15,4,13,-9,1,15,-9,1.8382106782106789,3.1934487734487718,-0.8950505050505058,-1.135627705627705,-2.9873304473304483,-2.4039971139971144,0.9238528138528146,-0.06311688311688357,-0.686681096681097,-1.135873015873015,1.0273304473304474,0.5524386724386723,-0.39398268398268144
2013,136,1277,65,1434,54,N,0,11,3,14,-11,1,11,-11,1.0450000000000017,4.40190476190476,-1.6713095238095228,-4.931904761904761,-1.6903571428571418,-1.892976190476194,3.651309523809525,0.7311904761904771,0.4965476190476181,-1.4786904761904758,1.4976190476190476,0.7319047619047621,-2.130476190476191
2013,136,1332,68,1329,55,N,0,13,12,5,7,-1,-13,-7,0.3076923076923066,0.6522435897435912,0.5336538461538467,2.450320512820511,2.1201923076923084,0.7211538461538467,-1.5448717948717938,-0.2804487179487225,-0.33814102564102555,-3.354166666666668,-1.1634615384615383,0.6282051282051277,1.0833333333333357
2013,136,1387,64,1308,44,N,0,20,4,13,-9,-1,-20,9,0.3948470209339767,-2.6594202898550634,-2.935185185185185,-7.397504025764896,1.624315619967792,4.000885668276972,1.7873590982286647,1.8655394524959767,-1.0165056360708533,2.4012077294686023,-1.4447665056360703,2.287037037037037,-2.0448470209339753
2013,136,1393,81,1285,34,N,0,47,4,13,-9,-1,-47,9,-0.7193422519509483,-6.281029357116317,1.158398364920104,0.36956521739130466,2.58835005574136,0.5786882199925714,-7.601635079895949,0.6767930137495384,-1.3368636194723145,-0.17056856187291025,-3.001021924934969,-3.1914715719063547,2.178929765886288
2013,136,1433,88,1103,42,N,0,46,5,12,-7,-1,-46,7,-0.8926923076923075,-1.7359615384615452,-0.19634615384615461,1.109551282051278,-0.4070512820512828,1.0821153846153848,0.020576923076923492,2.315128205128204,0.7228846153846149,1.808653846153847,-2.940897435897437,3.0132051282051275,-0.9954487179487188
2013,136,1455,73,1338,55,N,0,18,9,8,1,-1,-18,-1,0.6794871794871824,-1.049679487179482,-1.3076923076923075,-4.160256410256409,-0.39583333333333215,1.012820512820511,-0.004807692307693401,-3.4214743589743577,2.6089743589743595,-2.219551282051283,-0.6089743589743586,-0.42147435897435903,-0.1650641025641022
2013,137,1166,67,1153,63,N,0,4,7,10,-3,-1,-4,3,-3.3222703222703203,3.3243145743145774,-1.270562770562771,0.4978354978354993,-0.3268398268398265,1.7331649831649862,4.916546416546417,-0.7479557479557428,-3.8799903799903817,0.6664261664261666,1.650913900913901,3.1225348725348727,0.2067099567099575
2013,137,1181,73,1107,61,N,0,12,2,15,-13,-1,-12,13,-5.475462962962965,-10.572222222222223,-1.194907407407407,-4.224074074074075,-0.9351851851851851,-0.6717592592592609,0.3148148148148149,0.6615740740740748,-2.4685185185185183,3.2763888888888886,-1.8180555555555555,-1.0638888888888887,-2.6555555555555586
2013,137,1195,78,1207,68,N,0,10,15,2,13,1,10,13,4.308787878787882,8.827878787878788,1.1072727272727274,4.375151515151519,0.9957575757575761,1.4460606060606054,2.406666666666668,1.754545454545454,-0.14242424242424256,1.9448484848484853,1.666969696969696,0.32969696969696916,-0.46272727272727465
2013,137,1196,79,1322,47,N,0,32,3,14,-11,1,32,-11,-1.6420257374204752,-6.569729612492772,2.671486408328513,4.477082128397917,-7.6494722382880305,-10.199826489300175,-3.7545185078079815,0.1064560439560438,-0.2282388663967616,-2.903520821283978,-2.7056824754193194,-1.7746168305378829,-5.981781376518221
2013,137,1228,57,1160,49,N,0,8,7,10,-3,-1,-8,3,-0.24567099567099504,-3.057359307359306,-1.962662337662337,-7.600108225108226,1.9621212121212128,3.784632034632036,0.15205627705627833,3.847402597402599,0.16666666666666607,1.766233766233766,-0.12012987012986986,-0.8419913419913421,-2.1471861471861473
2013,137,1231,83,1241,62,N,0,21,1,16,-15,1,21,-15,3.015740740740739,1.554365079365077,1.1611111111111105,-0.2509259259259231,3.3421957671957667,2.8015873015873005,2.3313492063492074,1.7297619047619044,1.821296296296298,1.2907407407407412,-0.7338624338624342,-1.087698412698412,-0.003042328042326403
2013,137,1235,76,1323,58,N,0,18,10,7,3,1,18,3,2.676565656565657,5.977474747474751,3.9881818181818165,9.656060606060606,2.822828282828283,3.0750505050505055,0.7730303030303034,2.2718181818181797,-0.7386868686868677,2.2525252525252526,1.2937373737373736,-1.1241414141414139,2.762323232323233
2013,137,1242,64,1443,57,N,0,7,1,16,-15,1,7,-15,1.9569267997580155,1.6563218390804622,-0.7047186932849359,-3.1764065335753173,1.357168784029037,1.0756805807622456,-0.10514216575922575,2.2812462189957614,2.7048396854204473,-1.3490018148820333,0.5700544464609791,2.677797943133696,-0.664428312159707
2013,137,1247,63,1243,61,N,0,2,13,4,9,-1,-2,-9,-1.7341269841269842,-1.6932234432234452,-0.15170940170940206,-0.4050671550671545,-0.9652014652014653,-0.4865689865689866,1.565323565323565,-1.0137362637362628,1.8165445665445663,-0.07448107448107422,-0.8266178266178263,0.16697191697191727,2.396520146520146
2013,137,1274,78,1334,49,N,0,29,2,15,-13,1,29,-13,1.2416666666666671,3.3314814814814824,-0.11944444444444446,2.24907407407407,-1.4111111111111114,-0.7194444444444485,0.6009259259259245,2.6768518518518505,-4.00462962962963,-0.512037037037036,0.6305555555555564,2.8342592592592597,-3.416666666666668
2013,137,1278,83,1417,63,N,0,20,11,6,5,1,20,5,-3.738888888888887,-7.551666666666662,0.12166666666666703,0.5455555555555556,1.5405555555555548,3.041666666666668,3.9938888888888897,-0.9333333333333371,-1.5816666666666634,2.763333333333332,-0.7666666666666666,2.1483333333333334,2.3327777777777783
2013,137,1279,57,1458,46,N,0,11,12,5,7,1,11,7,3.986299027059893,8.02635679537854,-0.6120401337792645,-1.7890126178169652,5.342695348130132,6.145522955305562,2.443257829127395,1.2816205533596836,-1.442592733353603,1.6777135907570688,2.35609227728793,1.1870629370629375,2.799369109151719
2013,137,1314,78,1437,71,N,0,7,8,9,-1,1,7,-1,6.4805315965499055,13.241453969371591,1.0520594965675052,1.7028164055623982,-7.048063721175847,-8.598081323710616,2.570691779616265,-0.8174441119521205,3.622707269846858,-3.5254708678049624,0.27281288505544943,-0.46439887343777464,-4.064222848090122
2013,137,1326,95,1233,70,N,0,25,2,15,-13,-1,-25,13,3.9739010989010985,5.994230769230768,2.102197802197802,4.464285714285712,3.301373626373625,2.019505494505495,0.7774725274725274,1.374175824175822,2.7379120879120897,1.3140109890109883,0.045329670329669725,-0.973351648351648,0.6274725274725235
2013,137,1361,70,1328,55,N,0,15,7,10,-3,-1,-15,3,1.1659090909090928,0.5272727272727309,-0.5750000000000002,-3.0249999999999986,1.40909090909091,0.3227272727272741,0.672727272727272,-0.7681818181818194,0.6477272727272734,0.22499999999999964,-0.6500000000000004,-1.2727272727272725,1.6068181818181806
2013,137,1396,76,1301,72,N,0,4,9,8,1,-1,-4,-1,2.727596618357488,-2.8560990338164345,-2.394384057971015,-9.595108695652172,0.2694444444444457,2.6813405797101453,0.36038647342995134,2.3848429951690804,-0.46413043478260896,2.3213164251207736,-1.329891304347826,0.5342391304347829,-0.8010869565217398
2013,138,1112,74,1217,51,N,0,23,6,14,-8,1,23,-8,2.7628571428571433,9.741746031746032,1.356190476190477,5.191746031746032,-2.53380952380952,-3.912857142857142,4.545714285714286,1.6885714285714286,0.7704761904761881,-0.8926984126984134,-0.701428571428572,-0.2893650793650795,1.0255555555555542
2013,138,1257,82,1161,56,N,0,26,1,8,-7,-1,-26,7,-1.2376499250374806,-1.8228073463268402,-0.18952398800599646,-1.2632496251874041,0.05612818590704549,-0.5798913043478287,1.5499812593703144,1.3377436281859083,-2.5904047976012006,-1.9281859070464762,-5.993778110944527,-1.7730509745127434,-1.269508995502246
2013,138,1266,74,1139,72,N,0,2,3,6,-3,-1,-2,3,-0.5076086956521735,0.6171739130434801,1.8920652173913046,4.433478260869567,-1.7516304347826086,-1.4223913043478262,-0.22967391304347906,2.016304347826086,-0.5707608695652198,-0.15576086956521884,-1.1146739130434788,-1.0028260869565218,0.03576086956521607
2013,138,1276,78,1433,53,N,0,25,4,5,-1,1,25,-1,0.6201648351648359,-2.484532967032969,-0.10634615384615476,-1.2342582417582442,-2.8160989010989006,-4.253598901098897,-3.7079945054945043,2.92989010989011,-0.35854395604395606,-2.0327747252747237,-4.028516483516484,0.28796703296703274,-5.746401098901099
2013,138,1277,70,1272,48,N,0,22,3,6,-3,-1,-22,3,3.1916666666666664,3.0,0.6291666666666664,0.058333333333331794,0.5958333333333332,3.012500000000003,0.2291666666666643,-0.6416666666666693,2.2875000000000014,2.695833333333333,0.9666666666666677,2.475,5.241666666666664
2013,138,1332,74,1387,57,N,0,17,12,4,8,1,17,8,1.2594373219373232,2.1810897435897516,-2.218839031339032,-4.198005698005698,-0.06000712250712503,0.9362535612535581,2.271723646723647,1.6577635327635356,-0.33778490028489827,3.430555555555557,1.5708689458689458,0.9504985754985755,-0.31712962962962976
2013,138,1393,66,1143,60,N,0,6,4,12,-8,-1,-6,8,0.987179487179489,-0.09156954156954811,-1.6844211344211342,-4.652272727272727,-1.0020979020979013,-2.8404817404817386,-3.5173465423465426,2.9139471639471637,0.3673853923853905,-0.29079254079254113,-2.3669968919968927,-1.0623543123543122,-0.2596736596736591
2013,138,1455,76,1211,70,N,0,6,9,1,8,-1,-6,-8,1.9878205128205124,-2.603846153846156,-1.1410256410256414,-2.88525641025641,3.2333333333333343,3.4878205128205124,-2.3298076923076927,-1.3006410256410277,1.3464743589743602,-1.5487179487179485,-0.7048076923076927,-1.5881410256410255,-1.5733974358974372
2013,139,1181,66,1166,50,N,0,16,2,7,-5,-1,-16,5,-1.4285714285714306,-7.057142857142864,1.0783068783068783,0.6068783068783077,-2.7280423280423296,-3.06666666666667,-0.6047619047619062,2.9402116402116363,2.2857142857142865,1.716402116402115,-1.9867724867724865,-0.47354497354497305,-1.6031746031746046
2013,139,1195,81,1361,71,N,0,10,15,7,8,1,10,8,2.520454545454548,1.104545454545459,1.7022727272727272,3.1318181818181827,-1.1659090909090892,-1.302272727272726,0.4250000000000007,-0.995454545454546,2.7159090909090917,3.918181818181818,1.7886363636363622,-0.21363636363636385,2.252272727272725
2013,139,1196,78,1278,64,N,0,14,3,11,-8,1,14,-8,1.86959706959707,1.4116300366300294,2.9228021978021967,6.0827838827838825,-4.917673992673993,-6.795879120879121,-4.43543956043956,0.010622710622712361,-0.6685897435897452,-2.522161172161171,-0.5745421245421252,-2.8336080586080588,-3.033974358974362
2013,139,1231,58,1396,52,N,0,6,1,9,-8,1,6,-8,0.3808373590982299,-4.99637681159421,-0.5374396135265709,-5.708534621578096,3.3425925925925917,4.09661835748792,1.004830917874397,1.8973429951690797,-1.1095008051529778,2.6078904991948484,-0.615539452495975,-0.03381642512077265,0.32206119162641045
2013,139,1242,70,1314,58,N,0,12,1,8,-7,1,12,-7,-2.3796101949025505,-8.553823088455772,-1.0462518740629676,-2.7622188905547205,3.7044227886056955,4.481859070464765,-1.6634182908545725,1.7341829085457263,-1.941079460269865,1.5278860569715143,-1.0039730134932547,2.7894302848575707,3.1702398800599703
2013,139,1247,76,1279,74,N,0,2,13,12,1,1,2,1,-1.4753510378510377,-5.3926282051282115,0.29181929181929167,-0.7274877899877872,-2.5663919413919416,-4.462606837606835,-3.3524114774114775,-4.107142857142858,1.6978785103785103,-0.013431013431013383,-0.08615689865689902,-1.7548840048840058,-1.5132783882783905
2013,139,1274,63,1228,59,N,0,4,2,7,-5,-1,-4,5,-0.5119047619047628,2.220899470899468,1.0099206349206344,4.2056878306878325,0.7301587301587293,-0.8888888888888857,1.5205026455026456,-3.708994708994709,-0.2513227513227516,0.5013227513227516,0.6587301587301582,-0.22354497354497394,3.321428571428573
2013,139,1326,78,1235,75,N,0,3,2,10,-8,-1,-3,8,2.8751248751248752,4.751748251748253,4.101148851148849,9.467782217782215,1.7959540459540442,1.3371628371628361,1.3369130869130874,2.2175324675324646,2.9393106893106893,2.3526473526473524,-0.3384115884115886,-1.265484515484515,1.001248751248749
2013,143,1266,71,1274,61,N,0,10,3,2,1,1,10,1,-0.46739130434782794,-3.5711553945249577,-2.05012077294686,-5.013385668276971,1.91274154589372,1.5160024154589422,1.3720813204508868,-1.8681561996779372,2.9828904991948484,3.348631239935589,0.07578502415458921,-0.848933172302738,2.4175724637681135
2013,143,1326,73,1112,70,N,0,3,2,6,-4,-1,-3,4,0.5925274725274718,-0.03175824175824005,1.555824175824176,2.747912087912084,1.9515384615384619,1.1970329670329676,0.496263736263737,0.4742857142857133,1.217362637362637,2.151868131868131,-0.10802197802197888,-0.19626373626373583,-0.4832967032967055
2013,143,1393,61,1231,50,N,0,11,4,1,3,-1,-11,-3,0.9779202279202295,-2.660256410256416,1.2948717948717947,-0.6759259259259238,4.443019943019943,3.2948717948717956,-2.3782051282051277,1.2927350427350426,0.16595441595441685,-0.118233618233619,-1.1310541310541318,-2.2542735042735043,0.10968660968661226
2013,143,1455,72,1247,58,N,0,14,9,13,-4,-1,-14,4,1.4909951159951156,3.1794871794871753,0.4264346764346767,0.8734737484737494,-0.3452380952380949,-1.0010683760683747,-2.395680708180709,-2.924450549450551,0.2171092796092804,-1.3018925518925517,0.788843101343101,-0.6635378510378516,-2.5757783882783905
2013,144,1181,71,1277,61,N,0,10,2,3,-1,1,10,-1,2.6712962962962976,5.922222222222231,1.7282407407407403,5.524074074074072,3.1060185185185194,2.8884259259259295,-2.8023148148148156,-1.582407407407409,0.41435185185185297,-3.259722222222223,-0.8611111111111107,-0.5277777777777781,2.8888888888888893
2013,144,1196,62,1195,50,N,0,12,3,15,-12,-1,-12,12,1.3091908091908095,3.5012487512487525,-1.1705294705294698,-0.9676323676323655,2.51843156843157,3.593606393606393,1.610439560439561,0.5105894105894109,0.6178321678321677,4.073676323676324,2.1048451548451546,1.0116383616383615,3.16958041958042
2013,144,1257,77,1332,69,N,0,8,1,12,-11,1,8,-11,1.7029509283819593,2.9252320954907134,0.6008952254641908,1.20994694960212,1.5124336870026536,2.2711538461538474,1.0238063660477454,-0.7440981432360765,2.4986405835543763,-2.3163793103448285,1.852055702917772,-0.18932360742705567,1.3564655172413786
2013,144,1276,87,1242,85,N,1,2,4,1,3,-1,-2,-3,-1.8476847290640386,-2.8017733990147775,-1.0910344827586194,-2.8076847290640394,5.067093596059113,6.911921182266006,1.4616748768472902,1.8775369458128068,1.1355665024630532,4.084532019704433,0.7411822660098517,2.914088669950739,4.146699507389162
2013,145,1393,55,1266,39,N,0,16,4,3,1,-1,-16,-1,-0.7302118171683389,-5.222152545522114,-1.3108045336306207,-3.3559782608695663,0.763168896321071,0.005318654775180676,-2.941308992939428,-0.056902638424375596,-0.27708101077666214,1.3692865105908592,-2.0182320698625045,-2.5383918617614274,0.629110925306577
2013,145,1455,70,1326,66,N,0,4,9,2,7,-1,-4,-7,0.3914835164835182,1.4807692307692335,-0.5906593406593403,-1.3969780219780183,-0.31868131868131755,-0.1387362637362628,-1.8303571428571441,-0.8530219780219781,-0.6504120879120876,-1.854395604395604,-0.3482142857142856,-0.12568681318681385,-1.7534340659340657
2013,146,1257,85,1181,63,N,0,22,1,2,-1,-1,-22,1,1.213537675606645,0.5659003831417664,1.55683269476373,3.3269476372924665,-0.5987228607918258,-3.307407407407407,-4.058492975734355,-1.1395913154533837,-1.3182630906768846,-2.7141762452107265,-3.543295019157088,-0.6685823754789273,-0.11340996168582151
2013,146,1276,79,1196,59,N,0,20,4,3,1,-1,-20,-1,-1.8165934065934053,-3.5381318681318703,1.3378021978021977,2.836593406593405,-0.33362637362637493,0.2048351648351634,-0.2418681318681326,-0.3474725274725259,0.8345054945054944,1.685934065934065,0.5930769230769224,-0.17670329670329643,0.4819780219780192
2013,152,1257,72,1455,68,N,0,4,1,9,-8,1,4,-8,1.8039124668434994,4.53580901856764,-1.2404509283819634,-2.3381299734748033,3.267241379310345,5.521153846153847,0.7305371352785137,-0.3017904509283831,1.6332559681697632,0.19323607427055656,3.260709549071618,-0.28066976127320986,0.7122347480106086
2013,152,1276,61,1393,56,N,0,5,4,4,0,1,5,0,2.5400366300366315,0.8589499389499338,1.2937606837606834,1.7128571428571426,-3.114175824175824,-5.475286935286931,-4.224554334554334,1.1008302808302801,-0.5417704517704518,-3.05040293040293,-2.3671916971916973,-2.747289377289378,-2.879413919413917
2013,154,1257,82,1276,76,N,0,6,1,4,-3,1,6,-3,-1.2200985221674898,1.1982266009852225,-1.5427586206896553,-2.3490640394088693,5.842955665024631,9.125714285714285,3.1789162561576347,-0.12591133004925936,1.9148768472906408,3.250049261083742,4.399802955665025,0.7727093596059116,4.843251231527091
2014,134,1107,71,1291,64,N,0,7,16,16,0,1,7,0,-3.3387896825396837,-6.976686507936506,-4.156746031746032,-11.561011904761905,-0.2609126984126995,-0.46924603174603163,0.25099206349206327,1.9424603174603163,-0.7976190476190474,0.5714285714285712,-1.8030753968253972,-0.04662698412698418,-1.4801587301587311
2014,134,1301,74,1462,59,N,0,15,12,12,0,1,15,0,0.24679487179487225,2.0581501831501754,-0.8392857142857135,-0.6808608058608048,-1.4427655677655675,-1.3131868131868139,0.739468864468865,-2.1263736263736277,-1.977106227106228,-1.8475274725274708,-0.9290293040293038,1.255952380952381,-1.2696886446886424
2014,135,1142,81,1411,69,N,0,12,16,16,0,1,12,0,-2.7663287005392263,-1.119142553353079,0.057264373053845574,0.5758904837852228,-6.304815067972964,-8.357940305308727,-0.8727310700994906,-3.887521834890258,-2.066055289739502,-4.568067897015265,0.8106440343282451,-0.6942925495557071,1.7749297486139604
2014,135,1397,78,1234,65,N,1,13,11,11,0,-1,-13,0,4.049999999999997,5.275000000000006,0.47500000000000053,-0.34999999999999787,3.5249999999999986,3.8166666666666664,-0.33333333333333215,1.658333333333335,4.341666666666665,0.2833333333333332,2.166666666666666,0.24166666666666625,0.8249999999999993
2014,136,1163,89,1386,81,N,1,8,7,10,-3,1,8,-3,-1.588675213675213,0.23130341880342087,-0.41452991452991395,-1.0459401709401703,1.6223290598290578,-1.4919871794871824,-0.2622863247863254,-0.9791666666666679,-1.7676282051282062,-0.47542735042735096,2.223824786324786,1.4059829059829063,2.26923076923077
2014,136,1173,60,1326,59,N,0,1,11,6,5,1,1,5,1.4210144927536241,1.3974879227053094,1.0289371980676325,0.00971014492753497,-0.7837681159420278,-0.900386473429954,1.801304347826088,0.26140096618357944,0.8065217391304351,0.6994685990338176,-2.080966183574878,-1.6782125603864735,2.5100966183574904
2014,136,1196,67,1107,55,N,0,12,1,16,-15,-1,-12,15,-0.9481646825396837,0.24206349206349387,-0.7973710317460316,-1.936011904761905,2.8484623015873005,1.0932539682539684,0.12599206349206327,0.7705853174603163,0.34300595238095255,0.22767857142857117,-1.7562003968253972,0.7971230158730158,1.1604662698412689
2014,136,1217,61,1153,57,N,0,4,12,5,7,-1,-4,-7,-1.8249999999999993,-1.4079629629629622,-0.48499999999999943,0.9107407407407422,-1.1031481481481489,-1.75,2.3009259259259256,-0.43592592592592183,-2.2205555555555545,0.9333333333333318,0.3879629629629626,-0.3379629629629628,-1.1690740740740715
2014,136,1257,71,1264,64,N,0,7,4,13,-9,1,7,-9,2.19310344827586,3.47379310344828,1.349458128078818,4.120886699507388,-4.669261083743844,-8.038226600985222,-0.3093596059113306,-1.834581280788175,1.5784236453201963,-1.6665024630541883,1.2647290640394093,-1.8924137931034481,-4.274384236453201
2014,136,1276,57,1459,40,N,0,17,2,15,-13,1,17,-13,0.9665686274509824,-0.026813725490193008,2.059117647058823,4.982401960784312,2.264705882352942,0.5788725490196072,-1.4316176470588218,0.647598039215687,0.6884313725490188,-0.5526470588235277,-1.1357843137254902,0.887401960784314,-2.612745098039216
2014,136,1277,93,1174,78,N,0,15,4,13,-9,-1,-15,9,0.8901068376068366,4.685555555555553,-0.5521794871794876,0.6518376068376099,4.949658119658121,6.46905982905983,0.5067735042735055,-0.39408119658119745,-5.350811965811966,-1.668739316239316,-0.47485042735042704,-0.8308760683760692,0.33717948717948687
2014,136,1295,80,1328,75,N,1,5,12,5,7,1,5,7,-1.6631532718489233,-9.331466842336404,-3.111769872639438,-7.418642951251648,-1.8802151954325872,-1.7980895915678552,-2.5191040843214747,-4.157992973210362,-3.635924462011417,-1.0480895915678534,-0.8469477382520862,0.8184014053579274,-0.21102327624066675
2014,136,1332,87,1140,68,N,0,19,7,10,-3,-1,-19,3,2.0999121651295525,4.184563021519544,-2.5096618357487923,-6.036012296881864,1.8998682476943323,6.004611330698289,2.4609134826526144,5.234848484848484,0.8176328502415444,-0.26032059727711854,-0.6410847606499779,-0.08014931927975377,-1.9178743961352644
2014,136,1338,77,1160,48,N,0,29,9,8,1,-1,-29,-1,0.021923583662712076,2.0495300834431305,-0.232375933245498,1.3385331576635924,0.5717259552042151,0.24829161176987213,-0.23841018884497167,1.9841194554238015,-3.483768115942027,3.009292929292929,-0.5161089152393501,0.15219148001756677,-0.6087571365832254
2014,136,1361,73,1308,69,N,1,4,4,13,-9,-1,-4,9,2.8631481481481487,-2.1850000000000023,0.674074074074074,1.047407407407409,4.244814814814813,5.547407407407409,-1.5270370370370365,3.079444444444448,4.718148148148148,3.2803703703703704,-3.315925925925926,2.2940740740740737,0.8727777777777774
2014,136,1387,83,1301,80,N,1,3,5,12,-7,-1,-3,7,2.2375091575091552,2.457912087912085,-1.0590476190476181,-3.451098901098902,-1.2472893772893752,0.0082417582417591,1.7782783882783875,-2.810659340659342,-1.0504395604395604,-2.279670329670328,-2.5916483516483515,0.026190476190476097,1.5095970695970706
2014,136,1393,77,1444,53,N,0,24,3,14,-11,1,24,-11,0.13434343434343177,5.964814814814808,-1.3153198653198652,-3.459932659932658,-3.1478114478114474,-4.386700336700336,3.981313131313131,-2.4101010101010125,0.2282828282828291,-6.508080808080807,1.3843434343434353,1.0493265993265997,-2.852188552188551
2014,136,1400,87,1113,85,N,0,2,7,10,-3,-1,-2,3,-1.225145868624132,-4.954761904761902,2.9084697910784865,5.052079804253715,-0.4874364765669128,-1.503660831921703,-6.917607754564278,0.5779973649538874,0.6854696028609073,-0.7486166007905144,-0.7653585544889898,-0.5835591944287595,0.3078674948240163
2014,136,1437,73,1454,53,N,0,20,2,15,-13,1,20,-13,1.5741758241758248,1.7939560439560438,2.0126373626373617,3.3961538461538474,-0.08214285714285907,0.32390109890109997,0.7736263736263744,0.581318681318681,0.7384615384615394,-2.351923076923077,0.5282967032967036,0.7967032967032965,1.4153846153846175
2014,136,1458,75,1110,35,N,0,40,2,15,-13,-1,-40,13,-0.9065018315018349,-6.605128205128203,-0.7592490842490847,-3.5249999999999986,-5.727197802197804,-7.218498168498165,-1.8342490842490822,-0.9349816849816861,3.023992673992673,5.832142857142857,1.2737179487179482,-0.03131868131868165,2.231410256410257
2014,137,1112,68,1451,59,N,0,9,1,16,-15,1,9,-15,1.9309714795008937,8.13569518716578,-2.0460338680926915,-3.3159536541889487,-3.8244652406417092,-2.208244206773621,4.088725490196078,3.0630124777183596,1.2151515151515149,-1.4074866310160417,2.420053475935829,-0.21443850267379627,-2.029367201426023
2014,137,1124,74,1304,60,N,0,14,6,11,-5,1,14,-5,2.00937001594896,2.719497607655498,1.6214114832535893,2.113437001594896,-0.05442583732057393,1.920653907496014,4.897527910685806,-0.8369218500797473,4.624601275917065,0.8658293460925037,-1.672448165869218,2.3985247208931413,-2.460925039872407
2014,137,1166,76,1418,66,N,0,10,3,14,-11,1,10,-11,-0.6927822177822165,-4.897452547452545,2.4385614385614396,5.4605394605394615,-5.0904845154845155,-9.4252997002997,-5.232667332667333,1.2985014985015013,3.263561438561439,-3.729670329670329,-3.0692807192807194,-2.3184065934065936,-3.5609890109890117
2014,137,1211,85,1329,77,N,0,8,8,9,-1,1,8,-1,-0.1415343915343925,-3.0859788359788354,-0.9576719576719572,-1.8703703703703738,-5.362433862433862,-6.652116402116402,-0.021825396825395416,-0.896825396825399,1.1421957671957657,1.154761904761905,-0.7989417989417991,-0.6078042328042326,0.04828042328042059
2014,137,1235,93,1300,75,N,0,18,3,14,-11,1,18,-11,5.559890109890109,10.38461538461538,3.4725274725274726,8.917032967032968,-2.787912087912087,-2.400000000000002,0.16538461538461569,5.000549450549453,4.4895604395604405,-0.19230769230769162,-1.1758241758241752,-0.39560439560439553,-2.8131868131868103
2014,137,1242,80,1184,69,N,0,11,2,15,-13,-1,-11,13,-1.3428030303030312,-2.600378787878782,2.9678030303030294,6.508207070707069,-2.116161616161616,-4.305555555555557,-5.297979797979798,-6.712121212121211,-0.5599747474747492,-2.5422979797979792,1.8106060606060614,-3.9741161616161618,-0.5523989898989896
2014,137,1246,56,1243,49,N,0,7,8,9,-1,-1,-7,1,-0.10833333333333428,0.4541666666666657,0.7333333333333334,2.6625000000000014,-5.237500000000001,-7.104166666666668,-2.279166666666667,-2.6499999999999986,3.970833333333335,-0.4125000000000014,1.333333333333334,-3.0666666666666664,2.1416666666666657
2014,137,1272,71,1203,66,N,0,5,8,9,-1,-1,-5,1,-3.1073232323232354,-4.196969696969688,0.015782828282827843,-0.8030303030303045,0.9393939393939394,2.0214646464646506,-0.7159090909090917,0.856060606060602,-2.9387626262626263,-0.362373737373737,-1.64141414141414,-0.8554292929292928,-0.09027777777777857
2014,137,1273,78,1181,71,N,0,7,14,3,11,-1,-7,-11,0.37437290969899806,0.6783026755852788,0.916178929765886,1.398411371237458,-0.9843227424749177,-0.8626672240802655,0.5658444816053496,-2.8097826086956523,-0.9280936454849495,-2.983277591973243,0.06500836120401399,-0.778428093645485,0.5447324414715702
2014,137,1314,79,1344,77,N,0,2,6,11,-5,1,2,-5,3.5546772068511245,2.983091787439612,-2.1783047870004397,-4.987483530961789,-2.63350900307422,2.403601229688185,1.571146245059289,0.9457619675010989,1.4536671058410207,0.09288537549407039,1.7992973210364518,-0.07334211682037761,3.0858585858585847
2014,137,1372,77,1433,75,N,1,2,12,5,7,1,2,7,-1.0566976127320977,-6.447612732095493,0.39588859416445565,0.6458885941644574,-2.244860742705571,-2.6613063660477465,-1.1125663129973482,-4.306531830238725,2.383289124668435,-0.47562997347480085,-4.769562334217506,-1.5091180371352788,0.24154509283819792
2014,137,1390,58,1307,53,N,0,5,10,7,3,-1,-5,-3,-1.3214285714285694,-1.3835978835978864,-0.761243386243386,0.19642857142857295,1.5079365079365097,0.44708994708994965,0.3379629629629619,1.1990740740740762,2.69047619047619,-0.6990740740740726,-0.2850529100529098,1.1388888888888875,-1.150793650793645
2014,137,1397,86,1269,67,N,0,19,11,6,5,-1,-19,-5,2.691666666666663,3.987499999999997,-0.1416666666666666,-1.0874999999999986,-0.32083333333333286,0.283333333333335,-1.8583333333333343,1.4916666666666636,2.666666666666666,2.5458333333333343,1.541666666666666,0.7458333333333327,2.3666666666666707
2014,137,1417,76,1409,59,N,0,17,4,13,-9,-1,-17,9,-2.730311355311354,-3.2651098901098905,-0.5805860805860803,0.42605311355311315,0.9402472527472554,3.8459249084249123,0.4418498168498175,0.6856684981684964,-3.2559523809523814,0.479395604395604,-2.416666666666667,1.2639652014652012,3.345695970695971
2014,137,1438,70,1157,59,N,0,11,1,16,-15,-1,-11,15,3.073412698412696,6.61507936507936,1.0694444444444446,3.777777777777782,-0.3551587301587311,-0.5297619047619051,1.6726190476190474,1.7658730158730123,-1.5,3.515873015873016,1.5674603174603172,-1.5496031746031749,3.0615079365079367
2014,137,1455,64,1142,37,N,0,27,1,16,-15,-1,-27,15,-2.822966507177032,-0.7775119617224888,-0.48963317384370075,-1.456937799043061,-5.980861244019138,-7.2432216905901115,-1.3189792663476876,-5.440191387559807,-1.901913875598087,-1.7488038277511961,-1.4465709728867626,-2.4226475279106854,1.4928229665071768
2014,138,1163,77,1437,65,N,0,12,7,2,5,1,12,5,-1.4299450549450547,-1.058379120879124,-2.353021978021977,-6.052884615384613,-1.4649725274725274,-3.310439560439562,-0.2870879120879124,0.8571428571428577,-2.1009615384615383,0.4134615384615383,0.3111263736263732,2.693681318681319,-0.54326923076923
2014,138,1173,55,1393,53,N,0,2,11,3,8,1,2,8,2.076570048309179,-1.779549114331715,2.0681964573268923,2.637117552334942,0.22141706924315763,1.047020933977457,-2.0586956521739115,1.625845410628024,1.439855072463768,4.457246376811595,-1.7231884057971012,-2.198953301127214,3.7382447665056375
2014,138,1196,61,1338,45,N,0,16,1,9,-8,1,16,-8,0.39229166666666515,-1.2488888888888852,0.3445138888888888,0.5901388888888892,-3.720208333333332,-3.9172222222222217,-1.7702777777777783,0.43909722222222314,-3.7439583333333317,2.034861111111111,0.7138194444444448,-0.8168055555555558,-1.2661805555555574
2014,138,1257,66,1387,51,N,0,15,4,5,-1,1,15,-1,3.8731034482758595,7.050459770114948,2.0151724137931035,4.438505747126435,-0.05735632183908024,1.393678160919542,3.3854022988505736,-2.1883908045976987,0.33413793103448164,-1.2879310344827584,1.5875862068965514,0.5775862068965516,3.2227586206896532
2014,138,1276,79,1400,65,N,0,14,2,7,-5,1,14,-5,-1.2136956521739108,-7.042499999999997,2.4965217391304337,4.507934782608693,-2.2228260869565233,-6.198152173913044,-6.3548913043478255,-3.330108695652175,-0.046521739130435336,-2.4904347826086948,-0.9728260869565224,-3.4196739130434777,-4.2576086956521735
2014,138,1277,80,1217,73,N,0,7,4,12,-8,-1,-7,8,-2.7471153846153875,-0.5549999999999997,-1.7938461538461548,-4.160384615384615,3.93576923076923,5.384615384615387,0.552884615384615,-2.9851923076923086,-2.7869230769230775,-0.950961538461538,1.3490384615384619,0.4663461538461533,-0.0011538461538478373
2014,138,1361,63,1295,44,N,0,19,4,12,-8,-1,-19,8,3.4928451178451176,-3.4154040404040416,0.39225589225589275,0.8897306397306401,1.7643097643097647,-0.2264309764309793,-4.615319865319865,-0.25883838383838054,2.9385521885521895,0.9031986531986522,-1.9890572390572396,0.17508417508417518,2.8547979797979792
2014,138,1458,85,1332,77,N,0,8,2,7,-5,-1,-8,5,3.1443435791261862,6.049702712746189,0.34207941816637444,-0.23671497584540901,1.9115703137442281,1.1829511068641523,2.166958645219516,-0.7683150183150147,2.273026490417795,3.6856452726017945,2.9837421033073204,-0.3057148165843824,6.590951319212188
2014,139,1112,84,1211,61,N,0,23,1,8,-7,1,23,-7,-0.9287037037037038,3.6157407407407405,-1.1768518518518523,-2.546296296296294,-0.4601851851851855,1.2675925925925924,3.052777777777777,2.961111111111112,-0.6981481481481477,-0.7666666666666675,-0.14629629629629548,-0.1148148148148147,-3.576851851851849
2014,139,1124,85,1166,55,N,0,30,6,3,3,1,30,3,-1.600399600399605,0.5929070929070832,-2.0294705294705295,-5.528721278721278,2.7654845154845162,6.404845154845155,5.196303696303696,-1.5212287712287704,-1.9385614385614396,1.6933066933066918,1.1738261738261748,3.8888611388611385,-0.12537462537462574
2014,139,1235,85,1314,83,N,0,2,3,6,-3,1,2,-3,1.0349179805701532,2.8011891490152365,4.0251101555449385,11.796185698359611,-0.003278122843340725,-3.305927164622819,-2.751672240802675,1.604209799861973,2.4460635982375116,-0.579431438127088,-1.1246350268089405,-1.8091123851993416,-2.604807028720071
2014,139,1246,78,1455,76,N,0,2,8,1,7,1,2,7,-0.24393939393939235,1.763257575757578,-1.7568181818181818,-4.531439393939394,1.4344696969696962,4.22007575757576,2.8420454545454543,-0.8689393939393923,-2.2428030303030297,2.274621212121213,-2.248484848484849,0.7537878787878789,2.96590909090909
2014,139,1390,60,1242,57,N,0,3,10,2,8,-1,-3,-8,1.5466269841269877,1.3363095238095184,-0.30059523809523725,0.4811507936507944,1.8134920634920633,2.456349206349209,2.5138888888888875,0.875,2.5029761904761916,2.1875,1.057539682539682,1.479166666666666,3.2728174603174622
2014,139,1397,83,1273,63,N,0,20,11,14,-3,-1,-20,3,2.342934782608694,3.192210144927543,2.4181159420289857,4.105434782608697,0.16829710144927645,-0.7402173913043484,-2.6373188405797094,-0.3027173913043484,3.1268115942028967,1.1509057971014478,1.4157608695652169,-1.0077898550724638,2.978985507246378
2014,139,1417,77,1372,60,N,0,17,4,12,-8,-1,-17,8,-2.816312997347481,-2.3322281167108727,0.9824270557029173,4.179542440318304,-4.485245358090184,-3.4882294429708196,2.5364721485411152,-5.931531830238725,-1.1551724137931032,0.8753315649867375,-3.163793103448276,0.08703580901856744,1.9963527851458913
2014,139,1438,78,1272,60,N,0,18,1,8,-7,-1,-18,7,6.000180375180374,8.631493506493499,0.7550505050505052,2.3030303030303045,-0.7251082251082259,-0.17622655122655217,1.5968614718614713,0.007034632034631727,4.9595959595959584,2.55880230880231,3.486652236652236,0.4655483405483398,1.3670634920634939
2014,143,1112,70,1361,64,N,0,6,1,4,-3,1,6,-3,2.7981481481481474,1.4444444444444429,0.4157407407407412,0.9351851851851869,-0.4046296296296301,-0.3620370370370374,-1.567592592592593,6.613888888888891,5.82037037037037,1.242592592592592,-1.7481481481481485,-0.0037037037037035425,-0.5444444444444443
2014,143,1173,82,1390,72,N,0,10,11,10,1,1,10,1,0.2329192546583876,0.48685300207039006,0.8013975155279507,1.792805383022774,-2.128053830227742,-2.204037267080743,1.7496376811594203,-1.2880434782608674,1.2803312629399581,0.9655797101449295,0.8399068322981371,-1.5637681159420298,1.083747412008286
2014,143,1196,79,1417,68,N,0,11,1,4,-3,1,11,-3,-4.042067307692307,-8.71153846153846,-0.8209134615384617,-2.3581730769230766,-3.69591346153846,-2.302884615384613,-0.04326923076922995,-1.3329326923076934,-5.140625,1.3052884615384617,-2.140625,-0.31490384615384626,-2.8425480769230766
2014,143,1458,69,1124,52,N,0,17,2,6,-4,-1,-17,4,0.7897102897102855,2.779720279720273,0.3551448551448555,-0.7045454545454533,-1.1658341658341662,0.7784715284715311,5.036963036963039,0.17107892107892297,2.4542957042957028,3.720779220779221,0.38811188811188835,1.8641358641358634,2.7867132867132867
2014,144,1163,81,1235,76,N,0,5,7,3,4,1,5,4,-5.52335164835165,-9.033653846153847,-1.5302197802197801,-5.760302197802197,0.2850274725274726,-1.6730769230769234,-1.3653846153846168,-2.1428571428571423,-5.444368131868133,0.3461538461538449,0.19024725274725274,3.260989010989011,1.0295329670329672
2014,144,1246,74,1257,69,N,0,5,8,4,4,1,5,4,-2.809770114942527,-5.659626436781608,-2.3635057471264362,-7.45933908045977,5.091522988505748,7.485488505747128,1.0587643678160923,3.4100574712643663,-2.7033045977011483,1.067097701149427,-4.227586206896552,1.3474137931034482,-0.9077586206896555
2014,144,1276,73,1397,71,N,0,2,2,11,-9,1,2,-9,0.5700000000000003,-1.1508333333333312,2.373333333333333,3.8275000000000006,-1.2583333333333329,-3.7775,-4.829166666666666,-2.272500000000001,1.0683333333333316,-1.2433333333333323,-0.17499999999999982,-2.225833333333333,-2.591666666666665
2014,144,1277,61,1438,59,N,0,2,4,1,3,1,2,3,4.173305860805861,5.267857142857139,3.195512820512821,6.657051282051281,-3.6831501831501825,-5.247710622710624,-0.2552655677655675,0.941620879120876,4.285256410256409,1.0057234432234434,1.4878663003663002,0.1646062271062272,1.685439560439562
2014,145,1196,62,1173,52,N,0,10,1,11,-10,-1,-10,10,1.788722826086957,4.213043478260872,0.9822010869565219,2.481793478260869,1.7164402173913054,1.4923913043478265,1.3538043478260882,0.0400815217391326,1.8971467391304344,0.08016304347826164,-1.465896739130434,0.3008152173913041,3.736277173913045
2014,145,1458,64,1112,63,N,1,1,2,1,1,-1,-1,-1,1.2768315018314986,4.33653846153846,-2.325915750915751,-5.583333333333332,-2.5771978021978033,-0.5768315018314993,3.5240842490842503,4.581684981684983,1.8739926739926727,2.757142857142858,1.5153846153846153,0.2686813186813186,1.0314102564102576
2014,146,1163,60,1277,54,N,0,6,7,4,3,1,6,3,-2.966346153846157,-2.1298076923076934,-1.2211538461538467,-1.9182692307692264,3.658653846153845,3.03846153846154,-0.5913461538461551,-0.2451923076923066,-4.052884615384615,-0.0625,0.1923076923076925,1.552884615384615,-0.01442307692307665
2014,146,1246,75,1276,72,N,0,3,8,2,6,1,3,6,0.18833333333333258,1.8466666666666711,-2.548333333333333,-5.781666666666666,5.695833333333333,11.148333333333333,5.6083333333333325,3.7058333333333344,-1.4891666666666659,2.7891666666666666,-0.22500000000000053,3.4924999999999997,4.75
2014,152,1163,63,1196,53,N,0,10,7,1,6,1,10,6,-0.65985576923077,3.1201923076923066,1.0420673076923075,3.790865384615387,2.724759615384615,0.5288461538461533,0.04326923076922995,1.203125,1.0396634615384617,-0.5552884615384617,-0.6911057692307692,3.7427884615384617,2.97235576923077
2014,152,1246,74,1458,73,N,0,1,8,2,6,1,1,6,0.8184981684981665,2.5657051282051313,-2.075915750915751,-5.304166666666667,3.51863553113553,7.210668498168502,5.803250915750917,2.756684981684984,-0.538507326007327,4.5863095238095255,-0.03461538461538538,2.4436813186813184,4.548076923076923
2014,154,1163,60,1246,54,N,0,6,7,8,-1,1,6,-1,-1.8775641025641043,-1.7339743589743648,1.4660256410256407,3.876282051282054,-4.392948717948718,-9.141987179487181,-4.490064102564103,-1.3583333333333343,0.5282051282051281,-0.9407051282051295,1.8182692307692312,0.08653846153846168,-0.79326923076923
2015,134,1214,74,1264,64,N,0,10,16,16,0,1,10,0,0.1012071326506323,3.004815134555841,-0.7009779114074774,-0.5518575851393166,-1.0984237318409136,-0.34096659919028127,1.7301068706834961,3.8438244224815463,-3.0851765301262226,-0.37825226244343746,-1.2567277923315077,1.3662628006668252,-1.4023428197189816
2015,134,1279,94,1140,90,N,0,4,11,11,0,-1,-4,0,2.3922705314009676,1.326086956521742,1.4728260869565215,1.9632850241545867,1.569685990338165,2.1066425120772934,-1.1532608695652176,-0.24577294685990125,2.5246376811594207,-0.38466183574879054,0.2061594202898558,-1.0384057971014493,1.2659420289855063
2015,135,1173,56,1129,55,N,0,1,11,11,0,-1,-1,0,0.7181521739130439,2.9518478260869543,2.4315217391304333,3.987717391304347,-4.093586956521738,-6.920652173913044,0.8006521739130434,-0.6505434782608681,-2.462391304347827,-1.6067391304347822,-1.0407608695652169,-0.5623913043478259,1.1982608695652175
2015,135,1352,81,1316,77,N,0,4,16,16,0,-1,-4,0,0.5166438824333568,0.009090909090915034,2.3300751879699257,5.913294600136702,1.0145078605604905,1.108339029391658,-1.1221120984278876,1.3677033492822979,1.3555194805194812,-1.3625085440874898,-2.3422932330827058,0.7256664388243332,-1.98168147641832
2015,136,1112,93,1411,72,N,0,21,2,15,-13,1,21,-13,2.7982649071358736,2.844086021505369,-0.005620723362659064,-1.8334555229716525,0.8175708699902273,0.5416666666666714,-0.8420087976539588,1.4554007820136832,2.660434995112416,-2.4277859237536674,0.3052297165200386,0.21273216031280517,1.5432551319648091
2015,136,1116,56,1459,53,N,0,3,5,12,-7,1,3,-7,4.932692307692307,9.729166666666671,0.5224358974358969,2.2179487179487225,2.9118589743589745,3.7435897435897445,3.6682692307692317,0.8397435897435912,3.2243589743589745,0.7099358974358978,1.2676282051282053,2.2804487179487176,0.8301282051282044
2015,136,1139,56,1400,48,N,0,8,6,11,-5,1,8,-5,-0.3038461538461519,1.0246503496503578,-0.530594405594405,-1.852447552447554,0.3398601398601393,2.0606643356643346,-0.13041958041958068,-2.5569930069930074,-2.3201048951048957,-1.36625874125874,2.6743006993006997,-5.055244755244756,1.1998251748251754
2015,136,1153,66,1345,65,N,1,1,8,9,-1,1,1,-1,-2.671536796536799,-4.429437229437234,-1.1378787878787886,-2.041991341991345,-2.621969696969696,-3.4232683982684016,-0.6968614718614727,-1.0165584415584412,-3.2707792207792217,-0.2107142857142854,1.1506493506493491,0.20854978354978382,-4.624025974025976
2015,136,1207,84,1186,74,N,0,10,4,13,-9,-1,-10,9,2.711775362318839,4.842701863354037,3.8846532091097306,8.528209109730849,-1.575181159420291,-3.0349378881987583,-1.346713250517599,-1.1136387163561068,-1.0092650103519674,-2.212474120082815,-1.2442546583850929,-0.7455227743271209,-2.386076604554866
2015,136,1209,57,1124,56,N,0,1,14,3,11,-1,-1,-11,-3.0386473429951693,0.3309178743961354,2.3864734299516908,4.021739130434781,0.04347826086956452,1.2753623188405818,5.086956521739131,0.09178743961352254,0.3526570048309168,1.4444444444444429,-0.7101449275362315,-0.4178743961352662,-1.7705314009661812
2015,136,1246,79,1214,56,N,0,23,1,16,-15,-1,-23,15,-3.1305147058823515,0.5606617647058769,0.24448529411764675,3.0735294117647065,-1.5569852941176485,0.204044117647058,-0.6452205882352953,-0.321691176470587,-4.064338235294118,3.6194852941176485,0.117647058823529,-2.7610294117647065,4.525735294117645
2015,136,1301,66,1261,65,N,0,1,8,9,-1,-1,-1,1,1.6655594405594414,2.508566433566429,-0.884615384615385,-0.7632867132867105,0.11206293706293735,0.4631118881118894,0.45559440559440567,1.714335664335664,3.549125874125874,3.977097902097901,3.0979020979020975,1.0057692307692303,-1.2494755244755211
2015,136,1314,67,1217,65,N,0,2,4,13,-9,-1,-2,9,-8.111417748917752,-9.788582251082246,-0.28484848484848424,-0.16893939393939483,-0.31185064935064943,-0.5403679653679632,-3.4462662337662344,-2.823538961038963,-5.695670995670998,-0.30335497835497804,0.5174242424242426,0.24686147186147167,-3.7349567099567125
2015,136,1323,69,1318,65,N,0,4,3,14,-11,-1,-4,11,-2.145072918086413,-3.843246558538908,-2.2789287174594524,-5.735082458770613,0.5123211121711879,0.5745263731770507,-0.4955022488755638,1.9593021670982687,0.33126618508927486,4.012511925855254,-0.8991549679705599,0.9456453591386125,-0.6078642496933337
2015,136,1326,75,1433,72,N,1,3,10,7,3,1,3,3,2.261742846525454,-1.8161649944258613,-0.4940356744704584,-4.161742846525456,-0.8997027127461905,-2.1401151988108538,-0.25691192865105705,0.5972686733556287,3.0262727610553704,0.4682831661092539,-1.45332590115199,0.8012263099219625,-2.1067261241174293
2015,136,1412,60,1235,59,N,0,1,14,3,11,-1,-1,-11,3.1402777777777793,3.30555555555555,2.243611111111111,5.728888888888889,-0.5288888888888899,0.32361111111111285,-1.4972222222222218,1.1344444444444477,1.2347222222222207,-2.665555555555555,-0.18777777777777693,-1.5447222222222226,-1.9911111111111133
2015,136,1417,60,1374,59,N,0,1,11,6,5,-1,-1,-5,-1.073076923076922,-6.5320512820512775,-1.8621794871794872,-4.823076923076924,1.2416666666666671,1.0115384615384606,-0.3429487179487154,-2.121153846153849,1.6147435897435898,1.2467948717948723,-0.3506410256410266,-0.13717948717948758,-0.4846153846153882
2015,136,1428,57,1372,50,N,0,7,5,12,-7,-1,-7,7,2.4498327759197345,6.165760869565219,0.3724916387959869,2.602842809364546,-0.1479933110367888,0.16889632107023544,3.3844063545150487,-2.4119983277591963,2.9201505016722393,1.6599080267558524,1.3961120401337794,-1.4063545150501677,5.080685618729095
2015,136,1437,93,1248,52,N,0,41,1,16,-15,-1,-41,15,5.000822368421055,2.1935307017543835,0.35361842105263186,-3.966008771929822,-6.371162280701753,-11.361293859649123,-3.4355811403508767,-2.1940789473684212,2.4443530701754383,-2.057291666666668,-1.3810307017543861,-1.2615131578947372,-4.097587719298245
2015,136,1462,76,1279,57,N,0,19,6,11,-5,-1,-19,5,-1.491941391941392,3.086080586080584,0.25412087912087955,1.296336996336997,1.6755494505494521,1.027747252747254,2.891117216117216,0.5370879120879124,-3.673626373626375,-0.4070512820512828,0.5061355311355307,1.0862637362637364,1.6760073260073227
2015,137,1173,66,1344,53,N,0,13,11,6,5,1,13,5,-1.6702272727272742,-5.585000000000001,1.0647727272727279,2.0263636363636373,0.1197727272727267,0.7193181818181813,-4.349318181818182,0.5443181818181806,-0.10727272727272563,0.06227272727272748,0.05113636363636331,-1.933409090909091,-2.3790909090909054
2015,137,1181,85,1352,56,N,0,29,1,16,-15,1,29,-15,3.8668006222452718,4.818965517241381,0.5688682914182008,2.9459748509204005,0.2996175784288315,2.3371791547835095,2.7903487166191336,1.6122958257713265,1.8559113300492616,-2.337665283899403,-1.6371208192896027,0.3853059372569354,-1.1016658024371289
2015,137,1211,86,1295,76,N,0,10,2,15,-13,1,10,-13,4.400665642601126,2.616359447004605,-0.8233486943164365,-2.1586021505376323,2.1368407578085,3.1059907834101423,2.313236047107015,3.0247055811571926,5.059395801331284,1.6824116743471578,1.7264464925755245,-0.4934715821812601,3.300819252432156
2015,137,1234,83,1172,52,N,0,31,7,10,-3,-1,-31,3,3.6937699981178227,4.268398268398265,4.965462074157726,10.838038772821381,-4.107189911537738,-5.058441558441562,-2.1552795031055894,-0.8817052512704713,2.5970261622435533,-1.2891022021456777,-1.041407867494824,-1.768680594767551,2.562111801242235
2015,137,1242,75,1308,56,N,0,19,2,15,-13,1,19,-13,-0.02142857142857224,4.929899267399271,1.1318223443223445,2.3399267399267405,0.1668040293040285,-0.39963369963369644,0.4356227106227095,2.958745421245421,0.4948717948717949,-1.112271062271061,-0.11625457875457901,0.8951465201465196,0.5365384615384592
2015,137,1257,57,1414,55,N,0,2,4,13,-9,1,2,-9,-0.9813596491228083,2.2554824561403564,-0.8848684210526319,2.016447368421055,2.1644736842105274,3.6063596491228047,2.6743421052631575,-0.6403508771929864,-2.521929824561404,-0.5416666666666679,1.7368421052631575,0.4714912280701764,-0.04276315789473273
2015,137,1268,65,1434,62,N,0,3,4,13,-9,1,3,-9,-0.9096296296296309,-2.9692592592592533,1.6388888888888884,1.8177777777777777,3.2414814814814807,3.2988888888888894,-2.64111111111111,-1.3825925925925944,-0.7692592592592593,-0.5303703703703704,-0.42703703703703777,-0.159259259259259,-0.3696296296296282
2015,137,1277,70,1208,63,N,0,7,7,10,-3,-1,-7,3,-3.6537737624694167,-4.25682288725767,-2.06248823640128,-3.4313005834744956,6.162525879917185,7.302277432712216,-0.5494071146245041,1.369094673442497,-4.115847920195744,1.1869941652550366,0.2648221343873516,-0.12328251458686257,-0.7120271033314509
2015,137,1320,71,1461,54,N,0,17,5,12,-7,1,17,-7,2.98719806763285,1.628019323671495,1.6309178743961343,0.20144927536231805,-0.11038647342995134,-0.43768115942028984,0.5171497584541065,1.4966183574879253,-2.158212560386474,-0.06956521739130572,-0.26908212560386513,0.15652173913043477,1.9975845410628033
2015,137,1328,69,1107,60,N,0,9,3,14,-11,-1,-9,11,-3.0045454545454575,-6.888257575757578,-0.4412878787878789,-2.4314393939393923,-0.14128787878787996,-0.1545454545454561,-0.5462121212121218,-3.490909090909092,-2.1469696969696948,-0.46969696969696884,-1.029166666666666,-3.3719696969696975,0.5295454545454561
2015,137,1332,79,1329,73,N,0,6,8,9,-1,-1,-6,1,-3.9504776269482136,-7.633892659627961,-0.6936274509803928,-1.100553041729512,1.6042295123177475,2.864630467571647,-1.6019984917043733,-1.0483283056812454,-2.298014077425842,0.5128519356460526,1.8540723981900458,0.9602187028657623,0.42345399698340813
2015,137,1361,76,1385,64,N,0,12,8,9,-1,1,12,-1,-3.407727272727275,-4.149772727272719,-1.002272727272727,-1.2329545454545467,-3.162727272727274,-2.7852272727272727,2.417727272727273,-1.4788636363636414,-2.538181818181819,0.7320454545454549,-1.3254545454545443,-1.6086363636363643,-2.6104545454545427
2015,137,1438,79,1125,67,N,0,12,2,15,-13,-1,-12,13,1.8338259441707692,2.472742200328412,4.19704433497537,10.98440065681445,0.14105090311986856,1.1339080459770123,-0.7337438423645324,0.1706075533661746,3.023316912972085,3.7680623973727414,0.4229064039408863,-1.1853858784893272,2.860919540229883
2015,137,1452,68,1138,62,N,0,6,5,12,-7,-1,-6,7,0.6956521739130395,-3.055555555555557,-1.0096618357487923,-4.043478260869566,1.2705314009661848,-0.7632850241545874,-3.9444444444444446,4.555555555555557,-1.7004830917874383,-2.2198067632850247,-3.521739130434783,0.758454106280193,-4.9227053140096615
2015,137,1455,81,1231,76,N,0,5,7,10,-3,-1,-5,3,3.4623931623931625,2.6742877492877497,1.9841880341880334,1.640527065527067,2.553062678062677,3.2500712250712276,0.26331908831908635,1.3096866096866115,1.3694444444444454,2.170584045584045,-1.6541310541310539,-0.8415242165242165,0.5429487179487182
2015,137,1458,86,1157,72,N,0,14,1,16,-15,-1,-14,15,0.25188172043010937,2.418548387096777,-0.4861111111111116,-1.6779569892473134,2.4829749103942653,4.202777777777783,2.1198028673835125,2.3451612903225794,-0.34390681003584334,4.485304659498207,3.1129032258064515,0.00967741935483879,4.385663082437276
2015,138,1112,73,1326,58,N,0,15,2,10,-8,1,15,-8,-0.7030855539971945,-1.993595137914916,-1.4416549789621316,-3.7275596072931254,3.310028050490885,5.155072463768121,-1.092964001870035,0.5530621785881245,-1.077279102384292,-0.05719962599345685,-0.9858111266947169,-1.7991584852734928,2.2488546049555858
2015,138,1246,64,1153,51,N,0,13,1,8,-7,-1,-13,7,-4.243315508021389,-5.543582887700538,-0.7457219251336902,-0.3270053475935839,-5.943048128342248,-6.801069518716581,-1.8526737967914446,-2.191978609625668,-3.3695187165775398,2.3323529411764703,-0.12245989304812888,-1.5368983957219253,-2.2248663101604294
2015,138,1301,71,1437,68,N,0,3,8,1,7,1,3,7,3.5449519230769226,4.965865384615384,-1.1091346153846153,-5.1355769230769255,-5.327403846153846,-7.934134615384615,0.602644230769231,1.141346153846154,-1.2391826923076934,-2.6790865384615383,-2.7302884615384615,1.2129807692307697,-2.322115384615387
2015,138,1314,87,1116,78,N,0,9,4,5,-1,-1,-9,1,-1.9281759906759959,-1.5766317016316975,1.7939976689976689,5.115675990675992,1.55944055944056,1.4041375291375324,-1.4947552447552432,-4.59222027972028,-1.6453962703962723,-0.35678904428904445,0.9395396270396272,0.12776806526806528,-0.7319347319347322
2015,138,1323,67,1139,64,N,1,3,3,6,-3,-1,-3,3,-2.3120689655172413,1.777899686520385,-1.9777429467084637,-4.5564263322883995,0.3194357366771161,1.4749216300940446,3.310031347962383,1.866614420062696,-2.731974921630094,1.6611285266457685,-0.10626959247648848,-0.0401253918495299,2.722570532915361
2015,138,1417,92,1412,75,N,0,17,11,14,-3,-1,-17,3,-1.1777777777777771,-2.636324786324778,-0.44380341880341856,-0.37350427350427395,1.2331196581196586,-0.06495726495726473,-0.41047008547008446,-1.0386752136752193,0.9873931623931647,1.8074786324786327,-0.1895299145299152,1.4645299145299147,-0.18504273504273527
2015,138,1428,75,1207,64,N,0,11,5,4,1,-1,-11,-1,0.44855072463768053,2.812189440993791,-1.7515010351966867,-3.1206004140786767,1.80072463768116,3.0947204968944106,2.074974120082814,-0.24505693581780363,-0.4146480331262943,1.204321946169772,2.1002329192546583,-0.19197722567287911,3.434989648033124
2015,138,1462,75,1209,67,N,0,8,6,14,-8,-1,-8,8,-0.08034718904283977,-0.8003928438711014,-1.744067526676222,-3.3997982693634867,-1.5277114190157661,-1.5757551627116833,-0.6872644263948615,-1.2980570154483146,-3.494399320486277,-0.9269788182831658,2.4924881881403618,1.3425439295004518,0.3694855868768876
2015,139,1181,68,1361,49,N,0,19,1,8,-7,1,19,-7,6.59879310344828,6.416465517241377,1.8387931034482756,3.588362068965516,3.129655172413795,4.025431034482757,0.751551724137931,1.9166379310344865,4.354482758620691,0.00870689655172363,0.9351724137931026,-1.2317241379310344,2.106379310344826
2015,139,1211,87,1234,68,N,0,19,2,7,-5,1,19,-5,3.3891216310571153,0.38475771540286985,0.7156123446446028,0.33057533863985356,-1.7967811758134324,-0.9524507750314193,-1.4089861751152064,2.3486594051110146,0.4973467392822233,0.34258483452031996,0.2899385560675878,-1.7207443094539867,2.8087557603686655
2015,139,1257,66,1320,53,N,0,13,4,5,-1,1,13,-1,0.1374999999999993,8.812500000000007,-2.320833333333333,-0.8708333333333336,2.133333333333333,4.237499999999997,5.829166666666666,-0.06666666666666998,-0.041666666666666075,-0.21666666666666679,2.3083333333333336,2.0916666666666672,1.5208333333333357
2015,139,1277,60,1438,54,N,0,6,7,2,5,1,6,5,2.623097542138023,4.995365953386951,2.1599654718095502,4.567216391804099,-0.6019944573167972,1.73660896824315,1.6669619735586743,2.7015128799236763,4.59890509290809,1.4501158511653252,-0.9304438689746037,1.2327018309027302,5.593725864340556
2015,139,1328,72,1173,66,N,0,6,3,11,-8,-1,-6,8,-2.4020454545454584,-8.244090909090907,-0.4579545454545446,-1.6872727272727275,1.647045454545454,3.8829545454545453,-3.1720454545454544,-2.8784090909090914,1.3063636363636384,-0.5513636363636358,0.3875000000000002,-2.2561363636363643,-0.31545454545454277
2015,139,1452,69,1268,59,N,0,10,5,4,1,-1,-10,-1,-2.93156199677939,-10.61070853462158,0.8442028985507237,-1.5700483091787447,-0.16827697262479901,-2.803140096618357,-8.04951690821256,3.3361513687600635,-3.3039452495974224,-2.090177133655395,-5.837761674718197,0.8156199677938809,-6.443639291465377
2015,139,1455,78,1242,65,N,0,13,7,2,5,-1,-13,-5,-0.09722222222222143,-0.09205840455840075,-1.422542735042736,-5.886396011396009,5.009793447293447,6.686609686609689,0.8190883190883174,3.1914173789173788,-0.3440170940170937,3.9013532763532766,-0.6743233618233617,0.37001424501424474,0.4198717948717956
2015,139,1458,72,1332,65,N,0,7,1,8,-7,-1,-7,7,2.3046594982078865,5.811603942652333,0.625,0.6164874551971309,0.17047491039426532,-0.5833333333333321,0.19758064516128826,1.8812724014336908,2.2894265232974895,4.406137992831542,2.3629032258064515,0.8346774193548385,6.013440860215052
2015,143,1112,68,1462,60,N,0,8,2,6,-4,1,8,-4,-0.4080704241994546,-0.23650005908070426,-1.0886210563629914,-3.2348457993619295,1.1279688053881625,3.7527472527472554,0.6354720548268933,-0.6362991846862798,-2.997282287604868,-1.1530190239867668,0.5257591870495091,0.5588443814250263,0.6647170034266772
2015,143,1246,78,1452,39,N,0,39,1,5,-4,1,39,-4,1.6686558681443557,-6.189684569479965,-1.3535095197499292,-6.289002557544759,1.879653310599604,0.3226768968456959,-3.776641091219096,5.443449843705601,0.9111963626030128,-3.1021597044614957,-3.9919011082693956,3.957232168229611,-6.7845978971298635
2015,143,1323,81,1455,70,N,0,11,3,7,-4,1,11,-4,2.21484674329502,-1.9366538952745884,0.4774904214559381,-0.2131864623243942,3.2350255427841628,4.4550446998722855,-2.6540549169859524,0.4610791826309075,1.1082375478927204,0.4105044699872291,-0.36586845466155804,-1.0393358876117493,-2.302873563218389
2015,143,1458,79,1314,72,N,0,7,1,4,-3,-1,-7,3,4.612108993157385,8.274987781036167,-2.0984848484848495,-6.0590175953079175,1.2285557184750733,2.6022727272727266,4.267656402737046,4.0258431085044,5.866446725317694,5.520405669599218,2.8704789833822093,1.1187683284457477,6.729349951124146
2015,144,1181,63,1428,57,N,0,6,1,5,-4,1,6,-4,4.979010494752625,9.1097263868066,-0.6079460269865065,-0.20783358320839795,0.03204647676161976,1.7683658170914534,3.9155734632683643,0.46598575712144097,0.8007871064467764,-0.4654235382308851,1.3589767616191901,-1.8234632683658178,0.14898800599699769
2015,144,1211,74,1417,62,N,0,12,2,11,-9,1,12,-9,1.3419354838709694,-2.400124069478906,0.19633995037220853,-0.02655086848635335,0.4651985111662533,0.32357320099255915,-0.9488213399503707,1.762220843672452,1.1515508684863534,-0.5561414392059554,-0.5011786600496286,-0.7964019851116628,0.7554590570719597
2015,144,1257,75,1301,65,N,0,10,4,8,-4,1,10,-4,-1.3105769230769226,0.16955128205128744,-1.1721153846153847,0.3855769230769255,0.171153846153846,0.6945512820512789,0.46506410256410113,-0.7871794871794897,-0.5576923076923066,0.6634615384615383,3.3865384615384615,-0.03589743589743577,-0.2195512820512775
2015,144,1277,62,1328,58,N,0,4,7,3,4,1,4,4,1.4490118577075073,-1.3102766798418912,0.7984189723320165,-0.4468379446640327,-2.6980237154150206,-0.9351778656126513,0.8175889328063235,-0.9790513833992094,4.288142292490118,-1.0138339920948631,-1.4057312252964422,-0.571739130434783,2.837351778656128
2015,145,1246,68,1323,66,N,0,2,1,3,-2,1,2,-2,0.4085192697768747,1.3669371196754625,-2.300202839756592,-5.806693711967544,3.5397565922920915,4.457809330628805,3.894523326572008,2.8267748478701833,1.2920892494929,0.8969574036511148,0.20709939148072998,4.05131845841785,1.915618661257609
2015,145,1458,85,1112,78,N,0,7,1,2,-1,-1,-7,1,1.6774193548387117,2.204301075268816,-1.801075268817205,-5.39247311827957,3.3548387096774217,6.666666666666671,0.7419354838709662,2.263440860215052,2.026881720430108,3.736559139784945,3.1075268817204296,0.19892473118279552,5.93548387096774
2015,146,1181,66,1211,52,N,0,14,1,2,-1,1,14,-1,1.6718576195773096,3.7383203559510605,0.6597608453837598,2.892797552836484,-0.05631256952169039,0.9605116796440463,2.0376807563959947,-2.70731368186874,-0.4574527252502776,-0.030728587319243772,0.5140433815350391,0.4119855394883203,-1.3352335928809822
2015,146,1277,76,1257,70,N,1,6,7,4,3,-1,-6,-3,-3.016057312252965,-0.11964756258234388,-2.0313735177865615,-1.0679347826086953,2.7025691699604746,2.8847990777338595,0.8236989459815547,-1.3451910408432184,-5.476778656126481,-0.37252964426877355,2.2307312252964424,0.6164361001317529,-1.9119729907773362
2015,152,1181,81,1277,61,N,0,20,1,7,-6,1,20,-6,1.7102357911953128,2.4701512879923655,-0.5550804143382857,0.2704272863568207,3.017224342374268,3.918563445549953,1.4494173367861531,-1.1627197764753987,-2.5672958975057902,-0.16132274771704935,1.6359036390895456,-1.0186213711326157,-1.8164270137658463
2015,152,1458,71,1246,64,N,0,7,1,1,0,-1,-7,0,2.1641366223908918,2.105313092979131,-1.3921568627450984,-4.7691334598355475,4.706831119544594,6.598039215686278,2.9010120177103094,3.409867172675522,3.523086654016444,3.391840607210626,3.171726755218216,3.7586970271979765,3.959519291587604
2015,154,1181,68,1458,63,N,0,5,1,1,0,1,5,0,4.107341490545053,6.262513904338157,-0.044540229885058125,-0.42709492028179596,1.2420745272525036,3.9712643678160937,3.2607990359658867,2.494299221357064,2.6016870596959585,4.235400444938821,3.3930756395995547,0.1996199480904708,4.546486837226546
2016,134,1195,96,1192,65,N,0,31,16,16,0,-1,-31,0,-0.5371889140271513,0.4925258564964494,2.1052844214608912,5.132453943115708,0.2437580801551391,-1.1531391402714917,-0.8521937621202333,-5.421097285067873,1.3839689722042667,1.0412693923723353,1.254403684550744,-1.5399967679379447,2.04326923076923
2016,134,1455,70,1435,50,N,0,20,11,11,0,-1,-20,0,1.9017448512585808,-2.502288329519452,0.8821730329167394,-2.2095031684562585,1.4966995247315609,2.6103348882239032,-3.1003564513289916,2.9026469811652866,1.0290991902834001,1.7493949128674533,-2.7234201725048397,2.268515666255941,-1.0164473684210549
2016,135,1221,59,1380,55,N,0,4,16,16,0,1,4,0,-2.225877192982452,-3.686716791979947,1.477443609022556,4.729323308270676,-1.2662907268170436,-2.6165413533834574,-2.034774436090226,-2.4448621553884706,4.225563909774436,-0.6459899749373434,-0.5670426065162912,-0.801065162907268,-3.1651002506265655
2016,135,1276,67,1409,62,N,0,5,11,11,0,1,5,0,0.6066017316017316,-0.5643939393939448,2.652164502164502,4.177164502164505,-4.249242424242425,-7.542640692640692,-2.3647186147186137,-0.9212121212121254,1.1154761904761905,-1.0159090909090907,-1.087445887445888,-0.35129870129870167,-2.116450216450218
2016,136,1114,85,1345,83,N,2,2,12,5,7,1,2,7,-2.681623931623932,-3.2834757834757866,-0.24002849002849036,-0.6137820512820511,1.1449430199430193,0.842414529914528,-2.6036324786324787,-4.580662393162392,-5.874109686609689,-1.409366096866096,2.506054131054131,-1.3826566951566948,2.6130698005697965
2016,136,1139,71,1403,61,N,0,10,9,8,1,1,10,1,2.7308897243107744,5.246741854636596,1.38577694235589,1.5666040100250598,-1.1751879699248136,-1.0372807017543835,1.2369674185463673,0.47042606516290775,0.8228070175438589,-2.0174185463659153,0.3118421052631577,-0.8318922305764405,1.1988095238095227
2016,136,1163,74,1160,67,N,0,7,9,8,1,-1,-7,-1,-0.6612012987012967,2.707738095238092,0.508116883116883,-0.2790584415584405,3.5628246753246735,6.167261904761904,3.8303571428571423,2.394859307359308,-0.3214826839826834,2.5175865800865793,-0.2705627705627709,-0.12689393939394034,1.606222943722944
2016,136,1181,93,1423,85,N,0,8,4,13,-9,1,8,-9,-0.5540372670807443,-2.1692546583850927,2.834161490683231,4.366149068322979,1.5782608695652147,1.518012422360247,0.3031055900621116,-1.3400621118012417,0.18291925465838688,-0.48385093167701854,-0.6229813664596264,-0.21118012422360222,-6.976086956521737
2016,136,1211,68,1371,52,N,0,16,11,6,5,1,16,5,0.3492857142857133,-2.301785714285721,1.341785714285714,3.495000000000001,-2.045,-5.040357142857147,-2.61107142857143,2.52035714285714,0.3521428571428551,-1.3582142857142863,-1.9853571428571435,-1.6367857142857138,-1.8003571428571448
2016,136,1231,99,1151,74,N,0,25,5,12,-7,-1,-25,7,-4.3442328042328064,-2.890158730158724,-2.2394708994708994,-1.7147089947089924,1.0170370370370367,2.08814814814815,-0.5253968253968235,-1.370476190476193,-2.6637037037037032,-0.3478306878306885,0.30783068783068757,-0.015767195767195652,-0.3845502645502634
2016,136,1235,94,1233,81,N,0,13,4,13,-9,-1,-13,9,-4.081818181818182,-1.161688311688323,1.419913419913419,5.118181818181821,3.9768398268398286,5.251298701298703,1.4807359307359302,-0.4212121212121218,-0.0655844155844143,1.5119047619047628,1.7961038961038964,-0.22900432900432843,3.9419913419913435
2016,136,1242,105,1122,79,N,0,26,1,16,-15,-1,-26,15,-0.711333671399597,-1.8183950304259682,-0.971602434077079,-1.120943204868155,2.052611561866126,3.709432048681542,0.9823782961460452,-1.4073909736308288,-0.4800329614604468,1.6802738336713983,0.5701064908722113,-0.2654665314401625,-2.742520283975658
2016,136,1246,85,1392,57,N,0,28,4,13,-9,1,28,-9,0.36057692307692335,-0.9631410256410291,1.3189102564102573,1.8541666666666643,3.4663461538461533,4.498397435897434,0.3253205128205128,0.04807692307692335,-0.9519230769230766,-0.5657051282051277,-0.07692307692307665,0.9423076923076925,4.782051282051281
2016,136,1274,79,1138,72,N,0,7,3,14,-11,-1,-7,11,-0.11458646616541301,4.619624060150386,0.6674436090225564,3.0824060150375914,2.4827819548872156,4.353157894736842,2.484661654135337,3.760977443609022,0.24684210526315908,2.9647368421052622,0.946616541353384,-0.1703007518796995,4.064436090225566
2016,136,1314,83,1195,67,N,0,16,1,16,-15,-1,-16,15,-1.0633012820512775,-2.256181318681314,-0.1840659340659343,-1.9650869963369946,-1.2945283882783887,1.183951465201467,-2.051167582417582,1.33356227106227,-4.435439560439562,0.9142628205128212,0.33173076923076916,-0.3612637362637363,0.58173076923077
2016,136,1344,70,1425,69,N,0,1,9,8,1,1,1,1,-3.9686335403726716,-2.435869565217388,-0.28457556935817774,2.865372670807453,1.5832815734989651,0.27536231884057827,-0.18105590062111787,-2.792546583850932,1.2697722567287784,-0.23483436853002004,0.5427536231884051,-1.6976708074534157,0.04145962732919628
2016,136,1428,80,1201,69,N,0,11,3,14,-11,-1,-11,11,0.9980072463768117,9.194347826086954,-1.1251449275362324,-1.4830072463768147,0.2715096618357489,1.1891666666666652,3.4116062801932365,-0.9263164251207705,-1.2161352657004834,-2.4832367149758454,3.3884299516908216,-0.156050724637681,7.109987922705315
2016,136,1438,81,1214,45,N,0,36,1,16,-15,-1,-36,15,0.17884615384615188,7.853846153846149,0.6837912087912077,6.155219780219781,4.283241758241758,9.541208791208792,4.831043956043956,4.209065934065933,-1.6557692307692307,4.147802197802196,0.20109890109890127,0.7906593406593405,3.502472527472527
2016,136,1455,65,1112,55,N,0,10,11,6,5,-1,-10,-5,4.603586956521738,0.40836956521739154,-1.121956521739131,-7.098369565217389,2.818369565217388,3.5466304347826068,-0.11782608695652108,2.092282608695651,0.18499999999999872,2.9653260869565212,-2.3683695652173906,1.8815217391304344,-2.0
2016,136,1463,79,1124,75,N,0,4,12,5,7,-1,-4,-7,0.9599567099567103,1.4642857142857153,0.44372294372294263,-0.2510822510822486,1.6428571428571423,0.5898268398268378,-0.05411255411255311,-2.9729437229437217,2.083333333333334,-1.4642857142857153,2.112554112554113,-0.3733766233766236,1.4361471861471813
2016,137,1218,77,1143,66,N,0,11,13,4,9,-1,-11,-9,0.5647826086956513,-0.5173913043478251,-0.41086956521739193,-4.353913043478261,-2.7934782608695627,-3.636521739130437,0.7860869565217392,2.3334782608695654,-2.7934782608695663,-0.34521739130434703,-3.4986956521739128,0.17608695652173978,-0.511304347826087
2016,137,1234,72,1396,70,N,1,2,7,10,-3,1,2,-3,2.4461038961038994,-0.5025974025974023,0.34047619047618927,-1.625541125541126,3.7562770562770567,4.546103896103894,1.4268398268398261,0.13030303030302903,2.4132034632034625,1.75865800865801,1.3629870129870127,1.0751082251082247,-0.00519480519480453
2016,137,1268,79,1355,74,N,0,5,5,12,-7,1,5,-7,-0.19642857142857295,-3.8244047619047663,-0.27380952380952284,-1.6666666666666643,-1.6517857142857117,-2.913690476190478,-2.0625,-0.4315476190476204,2.0386904761904763,0.7291666666666679,1.3779761904761907,3.2589285714285707,-3.1785714285714306
2016,137,1292,90,1277,81,N,0,9,15,2,13,-1,-9,-13,2.6424068268895837,3.0031696273075568,0.8336642284918145,0.02884012539185221,0.2228491814698721,-2.48780912574016,2.883838383838384,1.2648206199930314,6.1906652734238925,-0.3706896551724128,-1.9732671543016371,1.3800592128178337,0.1917450365726232
2016,137,1320,75,1400,72,N,0,3,11,6,5,1,3,5,-1.4071428571428584,-5.925000000000004,1.3464285714285715,1.7428571428571438,-2.5880952380952387,-6.267857142857146,-5.597619047619046,0.7928571428571409,0.48095238095237924,-0.40238095238095184,0.4119047619047622,-1.7166666666666668,-5.30952380952381
2016,137,1323,70,1276,63,N,0,7,6,11,-5,-1,-7,5,-0.7326839826839802,-0.3111471861471884,2.2905844155844157,5.922077922077921,-1.2938311688311686,-2.186147186147185,-3.017316017316018,-0.7251082251082259,1.3647186147186137,0.0892857142857153,0.175324675324676,-1.7922077922077921,0.3306277056277054
2016,137,1328,82,1167,68,N,0,14,2,15,-13,-1,-14,13,-1.3450000000000024,-1.307380952380953,-5.573690476190476,-9.959880952380953,-0.9307142857142843,1.5285714285714285,1.937619047619048,-1.8541666666666679,0.19500000000000206,-0.3720238095238102,1.3191666666666668,-0.061904761904761685,4.4944047619047645
2016,137,1332,91,1221,52,N,0,39,1,16,-15,-1,-39,15,-3.530701754385966,-3.846560846560841,-0.3953634085213036,0.8019353940406582,-1.7428989139515458,-2.455722639933164,-2.7742968532442216,-0.4292676134781388,0.7587023113338915,-0.3969646338067392,-0.27951824004455617,-2.217488164856586,-1.8359092174881653
2016,137,1372,70,1452,56,N,0,14,14,3,11,1,14,11,0.38607859531772704,-1.0558946488294367,1.9029264214046817,4.150877926421405,-3.9683110367892986,-8.033821070234112,-5.513545150501674,-0.7304765886287612,3.4069816053511683,-2.1115802675585282,-1.6429347826086955,1.070819397993311,-1.6222408026755843
2016,137,1386,78,1153,76,N,0,2,8,9,-1,-1,-2,1,-2.104882154882155,-0.49843674843674535,0.3289081289081288,-0.16909571909572207,-1.8738816738816766,-2.7967051467051505,3.356132756132755,-1.445214045214044,-0.11498316498316719,1.431746031746032,2.492688792688793,2.8329004329004324,-0.5988936988937006
2016,137,1393,70,1173,51,N,0,19,10,7,3,-1,-19,-3,1.0112666281087321,-0.4574204742625767,-2.325864661654135,-4.601989589358013,1.5628687102371313,2.7961249277038718,-1.840613071139387,3.9112666281087343,0.5031347599768665,0.9833198380566799,-2.47181029496819,0.42170040485829885,2.798403701561597
2016,137,1401,92,1453,65,N,0,27,3,14,-11,1,27,-11,-3.424450549450551,-8.075549450549445,0.3248626373626369,0.8548534798534817,-3.303342490842491,-5.57875457875458,-0.38850732600732485,-0.04716117216117155,1.79235347985348,0.5061813186813193,-2.7554945054945055,-0.7213827838827838,-1.693681318681314
2016,137,1433,75,1333,67,N,0,8,10,7,3,-1,-8,-3,-2.0194444444444457,-5.0347222222222285,-0.10416666666666785,-2.011111111111113,0.5749999999999993,1.3236111111111128,-2.184722222222222,-0.9402777777777764,-0.5055555555555564,-0.13333333333333286,-1.0583333333333336,-0.5041666666666669,0.281944444444445
2016,137,1437,86,1421,56,N,0,30,2,15,-13,-1,-30,13,-0.168338557993728,-0.3383228840125412,-3.06449843260188,-8.86065830721003,2.641144200626961,5.781974921630091,2.020611285266458,1.1116771159874617,-3.627742946708464,2.0950626959247636,2.0428683385579944,-0.04498432601880875,-0.47257053291536266
2016,137,1458,47,1338,43,N,0,4,7,10,-3,-1,-4,3,2.490151515151517,2.1022727272727266,-0.75,-1.3621212121212132,0.48636363636363633,-0.5636363636363626,0.6530303030303024,1.3378787878787897,4.224242424242423,1.2848484848484851,-0.919696969696969,0.13484848484848477,0.5780303030303031
2016,137,1462,71,1451,53,N,0,18,2,15,-13,-1,-18,13,-1.858534621578098,-11.521578099838976,0.4851046698872796,-0.21386876006441113,-1.2617552334943625,-0.6721215780998406,-6.568558776167471,2.337379227053141,-2.2853663446054764,1.8708937198067623,-3.3803945249597414,0.3839975845410626,-2.575261674718199
2016,138,1181,71,1463,64,N,0,7,4,12,-8,1,7,-8,1.3553830227743298,3.244306418219466,3.579503105590062,7.512111801242234,2.141407867494822,1.1375776397515516,-1.4422360248447195,-2.4358178053830244,-0.7606625258799156,-4.307349896480332,0.6130434782608702,-0.30693581780538315,-1.4559006211180154
2016,138,1211,82,1428,59,N,0,23,11,3,8,1,23,8,1.7267857142857146,4.535714285714285,0.37928571428571445,1.6624999999999979,-1.602500000000001,-3.0203571428571436,1.30892857142857,2.5703571428571443,-0.36285714285714477,-1.5557142857142843,0.31214285714285683,-0.9117857142857138,1.029642857142857
2016,138,1231,73,1246,67,N,0,6,5,4,1,1,6,1,-0.14736263736263666,-2.6619780219780225,2.3062087912087907,3.7003571428571433,-0.8213461538461537,-2.821730769230772,-0.7193681318681335,-1.510934065934066,1.3369230769230764,3.1751098901098906,1.290851648351648,-1.2455219780219782,-3.488241758241756
2016,138,1235,78,1114,61,N,0,17,4,12,-8,-1,-17,8,-7.425505050505052,-7.532227032227041,-1.1802549302549306,-1.7234848484848442,3.365139490139491,3.3894300144300136,-0.9202741702741708,-2.8762626262626263,-5.586459836459838,-0.8332130832130815,0.6250601250601253,-1.277657527657527,4.5612674362674355
2016,138,1242,73,1163,61,N,0,12,1,9,-8,-1,-12,8,-1.1662356321839091,0.10158045977011199,-0.3318965517241379,0.7484195402298859,-2.7797413793103445,-6.205028735632183,-0.615660919540229,-0.15359195402298909,-0.2892241379310345,-1.6199712643678161,-0.8232758620689653,1.9906609195402303,-2.8449712643678176
2016,138,1274,65,1455,57,N,0,8,3,11,-8,1,8,-8,1.7757298136645936,-4.473416149068328,-0.9733850931677024,-5.282655279503103,0.8194409937888203,0.7116304347826095,-2.878540372670807,-2.747717391304345,-1.7332142857142863,0.6974689440993789,-1.3822981366459626,0.5511645962732921,-3.048928571428572
2016,138,1314,85,1344,66,N,0,19,1,9,-8,1,19,-8,4.546014492753621,1.543012422360242,-2.030900621118012,-6.395134575569358,-0.8689958592132516,-1.7277432712215344,1.752484472049689,2.2687370600414063,1.5218944099378895,-0.6699275362318851,-0.8760869565217391,0.9655279503105589,1.172826086956519
2016,138,1438,77,1139,69,N,0,8,1,9,-8,-1,-8,8,1.8562271062271058,6.168131868131873,1.1230769230769226,2.568315018315019,4.122527472527473,6.374542124542128,2.513186813186813,1.5316849816849825,-0.03076923076923066,0.838278388278388,1.1844322344322347,0.2478021978021978,2.6012820512820483
2016,139,1268,73,1218,60,N,0,13,5,13,-8,-1,-13,8,-0.22166666666666401,2.5291666666666686,-0.5083333333333337,2.096666666666664,3.5458333333333307,7.513333333333335,0.9441666666666677,0.42249999999999943,1.375,0.21749999999999936,1.9649999999999999,-1.1916666666666664,4.661666666666669
2016,139,1323,76,1372,75,N,0,1,6,14,-8,1,1,-8,0.2735742518351181,-1.0544325239977397,-0.3766610201392808,-2.857067570111049,0.044193487671748244,0.5828345567475992,0.9108977978543216,2.697571993224166,-3.5764163372859006,-2.405590062111802,-2.368699416525504,0.5332015810276678,-6.4414455110107305
2016,139,1328,85,1433,81,N,0,4,2,10,-8,1,4,-8,-0.5395238095238071,-1.9813095238095286,3.692738095238095,5.372380952380951,0.7973809523809514,-0.2327380952380942,-1.8703571428571433,2.557738095238097,-0.025952380952382725,1.295238095238096,-1.809047619047619,1.1291666666666664,-2.6777380952380945
2016,139,1332,69,1386,64,N,0,5,1,8,-7,1,5,-7,-1.4351851851851833,-3.0674603174603163,0.5304232804232809,-1.3108465608465636,-0.019841269841272435,-0.08862433862434216,0.81084656084656,-4.56878306878307,-1.620370370370372,1.3835978835978828,2.170634920634921,1.810846560846561,1.8835978835978828
2016,139,1393,75,1292,50,N,0,25,10,15,-5,-1,-25,5,1.3981208849629922,1.4653212284791266,-1.0583466241360977,-3.9471843945528207,-1.2190937717253512,0.22974686132580757,-1.458737169263486,2.6481208849629922,-1.4350181981760919,0.19331983805668074,-1.888592401750297,-0.6487036355457412,3.8106980738559706
2016,139,1401,92,1320,88,N,2,4,3,11,-8,-1,-4,8,-2.5398351648351642,-6.358974358974365,0.5858516483516478,0.7999084249084234,-2.2204670329670346,-5.16529304029304,-7.046016483516484,-1.3218864468864489,-3.5661630036630054,-2.7264194139194142,-0.7861721611721615,-1.1298076923076925,-2.9729853479853503
2016,139,1437,87,1234,68,N,0,19,2,7,-5,-1,-19,5,0.8171592775041105,2.741871921182266,-0.5925287356321842,-5.056978653530379,0.5873563218390814,2.163793103448274,3.01855500821018,1.6513957307060743,0.10862068965517224,-0.2701970443349744,-0.41091954022988464,1.1199507389162564,-1.7766830870279158
2016,139,1458,66,1462,63,N,0,3,7,2,5,1,3,5,-3.334259259259259,-8.925925925925931,-0.8268518518518508,-3.8129629629629633,-2.432407407407405,-3.1759259259259274,-3.553703703703704,-2.413888888888888,-3.6268518518518515,-2.0805555555555557,-2.1981481481481477,0.42222222222222205,-4.087037037037035
2016,143,1242,79,1268,63,N,0,16,1,5,-4,1,16,-4,0.8204022988505777,2.1817528735632266,-0.501436781609196,-2.1609195402298873,1.5380747126436773,4.109195402298852,0.6989942528735646,1.2952586206896548,0.3017241379310338,0.286637931034484,0.4482758620689653,-2.2614942528735624,2.890804597701152
2016,143,1328,77,1401,63,N,0,14,2,3,-1,1,14,-1,1.0194505494505535,2.5555494505494494,3.1029945054945056,4.096098901098898,-0.0933241758241774,-1.8843406593406584,-1.864587912087913,1.7554945054945073,-1.8564010989011006,0.15453296703296715,-0.048791208791208796,1.1701923076923073,-1.0120329670329689
2016,143,1332,82,1181,68,N,0,14,1,4,-3,-1,-14,3,0.2601449275362313,1.7310789049919535,1.7818840579710145,3.8441223832528166,0.6929951690821241,0.33599033816425106,1.3342190016103057,0.37238325281803597,-0.4167471819645705,-1.099677938808373,-0.673993558776167,-0.9392109500805152,-1.6000805152979076
2016,143,1437,92,1274,69,N,0,23,2,3,-1,-1,-23,1,-0.4766502463054181,-3.606699507389166,-2.0872906403940883,-7.7722167487684715,1.0292610837438438,2.1737931034482756,0.10807881773398975,-1.0924137931034466,-3.3870935960591133,-0.1973399014778323,-1.2990147783251231,0.4985221674876854,-0.9976354679802988
2016,144,1314,101,1231,86,N,0,15,1,5,-4,-1,-15,4,-1.5159523809523776,-4.58642857142857,4.122142857142856,6.631904761904764,-1.224047619047619,-1.1209523809523816,-1.6142857142857157,-2.4033333333333324,-1.8292857142857155,2.880238095238097,0.9014285714285712,-0.2942857142857145,-0.7478571428571428
2016,144,1323,61,1458,56,N,0,5,6,7,-1,1,5,-1,3.586255411255408,2.1194805194805184,0.6070346320346314,0.8088744588744596,-1.939502164502164,-3.0019480519480517,-0.6898268398268392,1.1167748917748916,1.7840909090909083,-0.8226190476190496,-0.5824675324675326,0.73030303030303,-1.5508658008658038
2016,144,1393,63,1211,60,N,0,3,10,11,-1,-1,-3,1,3.034123770965877,1.4797223828802757,-1.3372932330827068,-3.196275303643727,-0.5114170040485835,-2.318160786581842,-1.2234702139965314,4.782695199537304,-0.37686524002313604,-0.3223944476576044,-3.206096009253905,-1.0125853094274144,0.5726894158473108
2016,144,1438,84,1235,71,N,0,13,1,4,-3,-1,-13,3,6.176573426573427,8.056443556443561,2.379786879786879,5.962037962037961,-0.7504162504162508,0.2490009990009998,-0.17923742923742836,4.032550782550782,2.707542457542459,2.2995337995337977,0.8686313686313687,1.1923909423909418,-0.9736097236097265
2016,145,1328,80,1332,68,N,0,12,2,1,1,1,12,1,0.49380952380952436,2.6691534391534404,3.005238095238095,4.652010582010583,-1.1665079365079372,-2.7230158730158713,-0.29211640211640244,4.224867724867728,0.012010582010582027,1.5767195767195776,-0.41275132275132265,0.01296296296296262,-0.8856084656084668
2016,145,1437,64,1242,59,N,0,5,2,1,1,-1,-5,-1,0.24827586206896868,-0.9198275862068925,-1.3689655172413788,-7.51551724137931,1.6129310344827594,4.2896551724137915,0.6086206896551722,2.2603448275862057,-1.9146551724137932,1.6146551724137943,-0.6043103448275859,-0.12844827586206842,1.9629310344827573
2016,146,1314,88,1323,74,N,0,14,1,6,-5,1,14,-5,2.4637445887445892,4.712662337662337,-1.899891774891774,-2.9945887445887465,2.408549783549782,2.432900432900432,2.4350649350649345,2.3820346320346317,4.013528138528139,1.4226190476190474,0.4491341991341997,0.5649350649350655,3.592532467532468
2016,146,1393,68,1438,62,N,0,6,10,1,9,1,6,9,-1.4159919028340084,1.8198380566801617,2.8403701561596293,8.636495083863508,1.709658762290342,4.31651243493349,2.280942741469058,0.8642278773857726,0.3532388663967616,2.7544823597455164,3.004337767495663,0.9489589358010408,-0.5180740312319294
2016,152,1314,83,1393,66,N,0,17,1,10,-9,1,17,-9,5.361504723346826,6.066150954308846,-3.3994360902255636,-7.725322922691348,1.7926306149990356,0.605648737227682,1.8536726431463268,3.2603142471563515,3.2552776171197237,-0.8483468286099871,-2.3532388663967616,0.5702718334297283,2.420546558704455
2016,152,1437,95,1328,51,N,0,44,2,2,0,-1,-44,0,0.46334975369458675,2.250443349753695,2.0127093596059122,-0.8322167487684737,0.5264039408866985,1.485221674876847,1.2309359605911325,2.9561576354679815,-1.8756650246305426,1.6940886699507391,-0.5533004926108367,1.6413793103448278,-0.7347783251231554
2016,154,1437,77,1314,74,N,0,3,2,1,1,-1,-3,-1,2.927873563218391,3.8597290640394064,-3.343719211822659,-9.80697865353038,1.4647372742200329,2.394745484400655,3.9423645320197043,2.4680623973727407,1.7479064039408883,-0.02614942528735753,-1.1775862068965512,1.2699507389162568,0.7387931034482733
2017,134,1243,95,1448,88,N,0,7,11,11,0,1,7,0,-3.5888663967611336,-5.846356275303641,-0.9767206477732797,-1.2266194331983833,-2.5672064777327925,-1.0879554655870471,-1.354149797570848,-2.4649797570850183,-0.7554655870445348,1.3467611336032395,2.2750000000000004,0.007591093117408576,-2.1184210526315823
2017,134,1291,67,1309,66,N,0,1,16,16,0,1,1,0,-0.4902617506332696,1.089942771366914,3.048090815273479,6.841007599211935,-4.150989773899992,-5.0510273008725015,-4.297063514400977,-0.3547799981236537,-3.9723520030021575,-3.627779341401631,-1.1493385871094848,0.9979923069706351,0.2513087531663416
2017,135,1413,67,1300,63,N,0,4,16,16,0,-1,-4,0,1.7946969696969681,2.4125000000000014,1.2803030303030294,5.634469696969699,-2.272348484848484,-3.9878787878787847,1.3378787878787861,1.005303030303029,0.9200757575757557,-1.471212121212119,0.27310606060606,-0.11553030303030365,-2.7386363636363633
2017,135,1425,75,1344,71,N,0,4,11,11,0,-1,-4,0,-2.2124999999999986,-4.831944444444446,-0.7041666666666666,-1.7013888888888928,-2.0763888888888893,-1.8041666666666671,-1.7208333333333332,-0.4611111111111086,-0.8041666666666671,1.1194444444444454,0.08194444444444482,-2.0611111111111113,1.1222222222222236
2017,136,1112,100,1315,82,N,0,18,2,15,-13,1,18,-13,-2.4460526315789473,-4.324999999999996,-1.0672514619883033,-2.365789473684213,0.9445906432748536,0.1937134502923996,1.2807017543859658,-1.4583333333333286,-2.6451754385964925,-2.067690058479533,-1.344298245614036,0.3114035087719298,-3.720321637426899
2017,136,1139,76,1457,64,N,0,12,4,13,-9,1,12,-9,-0.804347826086957,-2.8378623188405854,-2.0625,-3.8768115942028984,-2.0108695652173907,-3.679347826086957,0.695652173913043,-4.942934782608695,0.2653985507246386,-3.0434782608695663,-0.1838768115942031,-2.8940217391304346,-0.014492753623191135
2017,136,1196,80,1190,65,N,0,15,4,13,-9,-1,-15,9,0.2391666666666623,-3.8089285714285737,0.08499999999999996,-2.1325000000000003,-0.17130952380952458,0.2835714285714275,-1.4611904761904757,0.8246428571428552,2.2978571428571435,4.324523809523811,1.0076190476190483,-0.3527380952380943,1.5077380952380928
2017,136,1199,86,1195,80,N,0,6,3,14,-11,-1,-6,11,-2.1297515527950353,-4.045450310559005,-0.1432608695652169,-0.5615683229813655,-1.5294409937888211,-3.1394409937888206,-0.11776397515527925,-0.27885093167702024,-0.7240993788819878,1.161180124223602,-1.9817236024844718,-1.707748447204969,0.03281055900621155
2017,136,1211,66,1355,46,N,0,20,1,16,-15,1,20,-15,3.0,2.3125,-4.0,-7.921875,-1.09375,3.046875,1.578125,2.859375,-0.890625,0.734375,2.46875,1.015625,-0.34375
2017,136,1235,84,1305,73,N,0,11,5,12,-7,1,11,-7,2.943167701863352,2.583074534161483,1.3087474120082803,0.9757246376811608,-4.426345755693582,-6.7379399585921345,-1.7311076604554856,-1.2106107660455478,-0.0883540372670808,-0.7572981366459626,2.1937888198757767,-1.165838509316771,-0.6915631469979289
2017,136,1292,81,1278,72,N,0,9,12,5,7,-1,-9,-7,-0.5359195402298873,4.851053639846739,-0.8113026819923377,-1.4202586206896548,4.955459770114944,5.419779693486589,1.9679118773946342,3.259818007662833,0.1022509578544053,0.1487068965517242,-0.9267241379310347,3.7428160919540225,-1.9030172413793096
2017,136,1321,68,1435,66,N,0,2,8,9,-1,1,2,-1,1.1768254628666526,3.3352749462589344,-3.0668608279592267,-5.970404271548436,-1.6867207544553082,-1.5404271548436306,2.1131197559115193,-1.5245683378406483,1.238014007350392,-1.8259898758754591,0.8022536578600645,0.7308924485125852,2.1900977740794687
2017,136,1323,60,1343,58,N,0,2,5,12,-7,1,2,-7,1.675353535353537,0.6827272727272771,-0.7504040404040406,-2.7469696969696997,2.164242424242424,1.5163636363636357,1.266565656565656,-1.6735353535353497,2.4433333333333316,-0.650404040404041,0.2539393939393939,0.6382828282828283,-2.665151515151514
2017,136,1345,80,1436,70,N,0,10,4,13,-9,1,10,-9,2.0728571428571456,4.018571428571427,2.6957142857142866,3.7942857142857136,2.877857142857142,2.2942857142857136,0.865000000000002,3.7564285714285717,5.624285714285715,1.5399999999999991,-0.44571428571428484,-1.517142857142857,0.5271428571428558
2017,136,1388,85,1433,77,N,0,8,7,10,-3,1,8,-3,-1.2815934065934087,-3.7348901098901095,2.605082417582418,3.6043956043956022,-5.298763736263735,-8.025412087912088,-1.9876373626373613,-1.2623626373626387,-0.06318681318681385,-1.8550824175824179,-3.1929945054945055,-0.8337912087912089,-5.474587912087912
2017,136,1437,76,1291,56,N,0,20,1,16,-15,-1,-20,15,-1.1876627051499717,-0.6906621392190146,-0.3238256932654213,-5.2991511035653645,-1.702999434069044,0.0032823995472561762,-2.7859083191850598,1.2293152235427272,-0.9993774759479344,2.6208262591963774,-0.38477645727221343,1.1161856253537072,2.7006791171477076
2017,136,1438,76,1423,71,N,0,5,5,12,-7,-1,-5,7,4.392760942760944,10.816666666666677,2.242424242424242,9.788215488215485,2.661447811447811,4.6215488215488225,4.71010101010101,-1.1222222222222236,0.7205387205387197,0.9988215488215477,0.6840067340067337,-0.16094276094276072,3.6872053872053847
2017,136,1452,86,1137,80,N,0,6,4,13,-9,-1,-6,9,-2.03846153846154,-6.495192307692307,0.7740384615384608,0.5721153846153832,-2.3221153846153832,-4.00480769230769,-5.33173076923077,2.25480769230769,-2.16346153846154,-0.08173076923077005,-2.7019230769230766,-0.9471153846153846,-3.014423076923073
2017,136,1458,84,1439,74,N,0,10,8,9,-1,-1,-10,1,1.0315151515151548,-3.211515151515144,1.3592929292929288,0.7120202020202022,5.2516161616161625,5.112020202020204,-4.607474747474745,0.4772727272727266,1.46959595959596,1.2224242424242426,-2.5537373737373734,-0.7572727272727269,0.8348484848484823
2017,136,1462,76,1268,65,N,0,11,11,6,5,-1,-11,-5,-0.7435300207039326,0.04063146997929579,1.1935817805383024,2.4883639910813784,-1.9767080745341623,-2.757694298455167,-1.6886645962732914,-0.4355490523968797,-0.1586737537824483,0.07555940436375508,-0.7656374422678764,2.0699255454690237,0.5149108138238567
2017,137,1116,77,1371,71,N,0,6,8,9,-1,1,6,-1,1.004415584415586,0.8272150072150097,-0.0413275613275621,-1.282366522366523,3.402453102453105,1.0681673881673888,-2.3115440115440116,-2.566406926406927,0.7738239538239551,-1.9842712842712853,0.3736219336219335,1.8367676767676766,2.1547186147186146
2017,137,1124,91,1308,73,N,0,18,3,14,-11,1,18,-11,1.071785714285717,-1.9210714285714303,0.07000000000000028,-4.694523809523808,-4.126190476190477,-5.834523809523809,0.7988095238095223,-1.947738095238094,2.3313095238095247,0.6109523809523818,0.2515476190476189,0.828333333333334,-2.0152380952380966
2017,137,1153,75,1243,61,N,0,14,6,11,-5,1,14,-5,-0.19058355437665853,4.098541114058349,0.3433687002652519,3.2769893899204234,-3.1222811671087527,-4.334549071618035,3.12446949602122,-0.006763925729444509,-1.088063660477454,-3.1038461538461544,-1.0901193633952264,0.8089522546419099,-1.5783819628647215
2017,137,1181,87,1407,65,N,0,22,2,15,-13,1,22,-13,1.2570105820105866,0.6439814814814824,-0.4155423280423296,-1.5714285714285694,0.868253968253967,0.6195767195767203,0.15000000000000036,0.21951058201058515,0.27929894179894177,-0.65734126984127,-0.19801587301587276,0.981349206349206,0.8482804232804249
2017,137,1242,100,1413,62,N,0,38,1,16,-15,1,38,-15,5.069047619047616,5.153571428571432,3.1845238095238084,5.654761904761905,1.9833333333333343,1.6988095238095262,1.6690476190476176,1.1773809523809504,3.6059523809523792,-0.355952380952381,0.9119047619047622,0.6547619047619042,-0.5714285714285694
2017,137,1246,79,1297,70,N,0,9,2,15,-13,1,9,-13,3.0800940438871507,5.239655172413791,-1.485579937304074,-3.8142633228840133,4.590282131661443,5.801410658307205,0.32460815047021896,0.5945141065830732,1.3744514106583061,-1.1180250783699073,0.4945141065830718,2.5214733542319747,1.5299373040752364
2017,137,1257,78,1240,63,N,0,15,2,15,-13,-1,-15,13,-2.554563492063494,-6.9831349206349245,0.9345238095238093,0.09325396825396837,-0.9732142857142847,-2.4861111111111143,-2.4464285714285694,-0.14880952380952195,1.3125,2.703373015873016,-1.95436507936508,-1.3918650793650795,-1.5446428571428577
2017,137,1276,92,1329,91,N,0,1,7,10,-3,1,1,-3,-2.74531499202552,-7.326355661881976,0.40291068580542344,2.3430023923444985,-5.377093301435405,-6.515649920255182,-5.701754385964913,-1.4707934609250408,-1.1572966507177025,-3.5521331738437,-1.653608452950559,-0.36074561403508776,-6.148425039872407
2017,137,1277,78,1274,58,N,0,20,9,8,1,-1,-20,-1,-1.5760423786739537,-0.8173843700159509,-1.477158806106174,-3.117167919799499,1.0521758942811559,0.3794714057871964,1.5681818181818201,-2.685634540897702,-5.101218956482114,-1.4764183185235815,1.6753816359079519,-0.9113123718386875,-4.460925039872409
2017,137,1314,103,1411,64,N,0,39,1,16,-15,1,39,-15,4.577390001303044,6.579474872953142,0.5773465664770017,-1.2780046040915636,-3.561916344525038,-4.497339616904835,2.6864114146722855,3.8574360422186516,5.581592320722756,0.25114016418364216,-0.7235590496460063,0.6189245537071626,1.1988880684532859
2017,137,1332,93,1233,77,N,0,16,3,14,-11,-1,-16,11,1.461363636363636,3.299350649350643,1.2782467532467532,0.8757575757575751,1.3660173160173166,0.14080086580086615,-1.2915584415584398,1.8910173160173187,1.2905844155844157,1.0186147186147192,0.1998917748917748,-2.9145021645021645,2.047619047619051
2017,137,1348,84,1166,72,N,0,12,11,6,5,-1,-12,-5,4.347222222222221,2.312499999999993,2.3611111111111107,3.444444444444443,-3.1388888888888893,-5.541666666666668,-4.097222222222223,0.47222222222222143,3.979166666666666,0.8055555555555554,-0.18055555555555536,-3.0347222222222214,-4.340277777777775
2017,137,1376,93,1266,73,N,0,20,7,10,-3,-1,-20,3,4.375501253132832,-0.4812656641604036,4.083834586466166,4.314849624060148,-2.226754385964913,-5.539223057644108,-3.765413533834584,1.1837092731829593,3.9618421052631554,-1.1687969924812052,-0.5216791979949864,0.13095238095238093,-2.0502506265664167
2017,137,1417,97,1245,80,N,0,17,3,14,-11,-1,-17,11,-5.349627384110143,-1.1579512441581414,-2.148777946191739,-2.522688518378171,1.6190476190476186,3.3967569786535314,5.067733990147785,-2.657493368700262,-7.7339743589743595,1.2869931792345586,1.3639320449665275,-1.9558387015283567,1.1677245168624495
2017,137,1425,66,1374,65,N,0,1,11,6,5,-1,-1,-5,-0.7375000000000007,-2.1736111111111143,-0.6875,-2.618055555555557,-4.418055555555554,-4.170833333333334,2.0791666666666657,1.4638888888888886,-0.5458333333333325,-0.3138888888888882,-1.4847222222222216,-2.019444444444445,-0.7944444444444443
2017,137,1455,64,1173,58,N,0,6,10,7,3,-1,-6,-3,-0.06984900406939687,-3.3618012422360266,0.7591293638894836,0.14494538445063299,-2.55812272435211,-2.0769436710216347,-4.739505247376313,0.22978689226815163,0.8622295994859712,0.4431623473977293,0.8795245234525595,-0.09236453201970463,0.079701220818162
2017,138,1112,69,1388,60,N,0,9,2,7,-5,1,9,-5,1.105952380952381,0.07976190476190226,-2.4880952380952372,-5.192857142857143,5.870238095238095,7.815476190476193,0.7023809523809526,0.672619047619051,-1.8130952380952383,0.954761904761904,1.845238095238095,-0.29761904761904745,2.1345238095238095
2017,138,1139,74,1292,65,N,0,9,4,12,-8,1,9,-8,0.5555659670164914,1.527080209895054,0.6400862068965516,2.5362631184407824,2.590423538230885,1.059876311844075,-0.37115817091454417,-2.294227886056973,-1.0420727136431793,-1.644771364317842,-0.15226761619190388,-0.04703898050974509,-0.7508433283358329
2017,138,1196,65,1438,39,N,0,26,4,5,-1,1,26,-1,1.6617424242424264,5.887500000000003,-0.01590909090909065,2.648863636363636,6.885984848484847,9.161363636363637,2.8128787878787875,1.5124999999999993,-1.9840909090909093,1.7719696969696948,1.88030303030303,0.6950757575757569,2.211742424242427
2017,138,1211,79,1321,73,N,0,6,1,8,-7,1,6,-7,3.862648221343875,0.20145750988142197,-1.4670207509881426,-2.7167119565217384,3.5223567193675898,8.500679347826086,0.336277173913043,3.718811758893281,-1.9166872529644277,2.9970973320158105,2.683053359683795,-1.2126358695652169,-2.2555583003952577
2017,138,1345,80,1235,76,N,0,4,4,5,-1,-1,-4,1,0.9774534161490678,3.582360248447202,0.5927950310558998,2.6088198757763976,-2.992298136645964,-2.783416149068321,-0.8151552795031058,-2.3003726708074517,-2.651925465838511,-3.4294409937888197,2.6252173913043473,1.4298757763975152,-0.288944099378881
2017,138,1452,83,1323,71,N,0,12,4,5,-1,-1,-12,1,-1.3033760683760676,-3.0194871794871787,1.2360470085470086,2.1150641025641015,-3.219935897435896,-7.352371794871793,-4.721196581196583,0.66344017094017,-0.4717307692307706,-3.4972863247863266,-2.64801282051282,-0.8636111111111111,-6.61955128205128
2017,138,1458,65,1437,62,N,0,3,8,1,7,-1,-3,-7,0.1273118279569907,-1.9202150537634424,0.23949820788530474,4.280788530465951,2.954695340501793,1.115197132616487,-1.2571326164874534,-2.425806451612903,-0.8084587813620061,-0.5759139784946221,-0.10867383512544748,-0.48215053763440885,-0.5655913978494631
2017,138,1462,91,1199,66,N,0,25,11,3,8,-1,-25,-8,3.7519047619047647,5.422261904761903,-0.3588095238095237,-1.5746794871794876,-1.5171428571428578,-1.1745421245421248,-0.4971428571428582,0.20782051282051128,-0.7346520146520135,-0.9152014652014628,1.002188644688645,2.19731684981685,1.1226282051282048
2017,139,1124,82,1425,78,N,0,4,3,11,-8,1,4,-8,-0.5357142857142847,-3.1230158730158735,-0.9375,-2.1775793650793673,-4.385912698412698,-5.038690476190478,2.75297619047619,-0.8521825396825378,0.5238095238095237,2.575396825396826,-1.6448412698412698,-0.7361111111111107,2.7936507936507944
2017,139,1242,90,1277,70,N,0,20,1,9,-8,1,20,-8,3.287593984962406,6.019736842105267,1.5028195488721803,2.4483082706766908,4.791353383458645,6.213345864661655,2.5178571428571423,-0.7819548872180491,-0.692669172932332,-0.4163533834586488,2.0996240601503757,-0.5281954887218046,-0.622180451127818
2017,139,1246,65,1455,62,N,0,3,2,10,-8,1,3,-8,3.9094827586206904,4.339655172413792,-0.3594827586206897,-0.3810344827586185,-0.3853448275862057,0.9155172413793053,-1.6913793103448285,1.8060344827586228,0.28103448275861886,1.1215517241379303,-0.31379310344827616,1.4258620689655173,0.5974137931034491
2017,139,1276,73,1257,69,N,0,4,7,2,5,-1,-4,-5,1.106060606060609,5.6344696969696955,-3.0871212121212137,-5.327651515151512,1.46590909090909,4.41477272727273,4.541666666666666,3.740530303030301,-0.767045454545455,1.2878787878787854,0.7215909090909101,2.5,3.844696969696969
2017,139,1314,72,1116,65,N,0,7,1,8,-7,-1,-7,7,-2.480183150183148,-5.342698412698418,-0.6085103785103794,-2.2795360195360175,2.81953601953602,2.053931623931625,-3.5988400488400494,-2.9559340659340663,-4.433968253968253,-0.06752136752136906,1.2397557997558,0.8199511599511595,2.105934065934065
2017,139,1332,75,1348,72,N,0,3,3,11,-8,1,3,-8,0.8972222222222221,0.7240079365079382,1.87579365079365,4.887499999999999,-0.5232142857142854,-2.1003968253968246,-1.0259920634920654,-0.4301587301587304,0.9265873015873023,-0.4498015873015877,0.37460317460317505,0.05654761904761951,-3.9226190476190474
2017,139,1376,88,1181,81,N,0,7,7,2,5,-1,-7,-5,2.7748677248677254,-1.579828042328046,1.5642195767195766,1.8214285714285694,0.6694444444444443,-0.7375661375661373,-1.6952380952380945,2.25522486772487,0.574537037037036,-1.6311507936507947,-2.038492063492063,1.0337301587301586,-3.1041005291005312
2017,139,1417,79,1153,67,N,0,12,3,6,-3,-1,-12,3,-7.968965517241379,-6.372413793103448,-1.6543103448275867,-1.7146551724137957,-0.8068965517241367,0.5318965517241381,3.091379310344829,-4.3681034482758605,-6.37844827586207,-2.0646551724137936,1.5396551724137932,-1.0750000000000002,-1.6112068965517246
2017,143,1211,61,1452,58,N,0,3,1,4,-3,1,3,-3,0.0288461538461533,-4.502403846153847,-2.362980769230769,-3.80889423076923,0.48798076923077005,2.21033653846154,-3.0516826923076934,6.474759615384613,-3.69110576923077,0.49639423076922995,-1.7788461538461533,-1.046875,-5.334134615384613
2017,143,1242,98,1345,66,N,0,32,1,4,-3,1,32,-3,1.3914285714285697,2.0707142857142884,0.16499999999999915,1.037857142857142,2.6185714285714283,5.5378571428571455,1.8564285714285695,-0.7385714285714293,-1.7778571428571457,0.5421428571428564,1.2885714285714283,2.0599999999999996,3.0157142857142887
2017,143,1332,69,1276,68,N,0,1,3,7,-4,-1,-1,4,-0.3852272727272741,-4.011255411255412,1.2668831168831183,0.9609848484848484,-1.1093614718614724,-3.2171536796536806,-3.147619047619047,-3.088149350649349,-0.44426406926407047,-1.5741883116883102,-0.7489718614718619,-3.3482142857142856,-1.3179112554112535
2017,143,1462,73,1112,71,N,0,2,11,2,9,-1,-2,-9,-0.09642857142857153,-2.086904761904762,-1.6904761904761898,-5.53717948717949,-0.4154761904761912,-2.4162087912087884,-2.19047619047619,-0.7788461538461533,-2.2563186813186817,-0.9568681318681307,0.18635531135531114,0.26648351648351687,-1.0532051282051285
2017,144,1196,84,1458,83,N,1,1,4,8,-4,1,1,-4,0.7341666666666704,2.044166666666669,-0.4338888888888892,-0.6163888888888884,5.083055555555555,5.396111111111111,-0.2127777777777773,1.1125000000000007,-1.237222222222222,0.37166666666666615,0.5311111111111106,1.2241666666666662,2.9875000000000007
2017,144,1246,86,1417,75,N,0,11,2,3,-1,1,11,-1,-3.672413793103445,-1.4620689655172399,-2.1094827586206897,-4.152586206896551,5.1448275862068975,9.273275862068964,2.1189655172413797,-0.9094827586206868,-5.7232758620689665,0.44913793103448185,1.1258620689655174,-0.45775862068965534,1.7439655172413815
2017,144,1314,92,1139,80,N,0,12,1,4,-3,-1,-12,3,-2.975364309603439,-8.653338509316775,0.6284340659340657,1.4022634973721964,-0.5816113234591498,-2.0206939799331103,-5.721243430482563,-4.446368848542761,-4.460791925465838,-1.5290551839464896,0.2964345437171527,-0.8521261347348306,-0.3443920210224576
2017,144,1376,70,1124,50,N,0,20,7,3,4,-1,-20,-4,1.880357142857143,-3.3648809523809575,0.5619047619047617,-0.8630952380952408,-4.542857142857143,-6.570238095238096,0.7035714285714292,0.8636904761904773,3.4779761904761894,0.742857142857142,-2.7874999999999996,0.8392857142857149,-2.6761904761904773
2017,145,1211,83,1462,59,N,0,24,1,11,-10,1,24,-10,3.0119047619047628,1.248511904761905,-1.8050595238095237,-3.377804487179489,0.42410714285714235,2.484832875457876,-1.7165178571428577,3.559695512820511,-2.3740270146520146,0.6129235347985365,1.707188644688645,0.6154418498168499,-2.0761217948717956
2017,145,1332,74,1242,60,N,0,14,3,1,2,-1,-14,-2,2.610714285714284,2.114285714285714,1.2392857142857139,-0.3785714285714299,3.3357142857142854,4.9714285714285715,0.8464285714285715,1.6464285714285722,2.107142857142856,2.7285714285714278,-0.05714285714285694,-1.8392857142857144,2.267857142857146
2017,146,1314,75,1246,73,N,0,2,1,2,-1,-1,-2,1,-0.7852406214475138,-2.017487684729069,0.18489958317544541,0.9030693444486566,3.8865858279651384,6.020291777188326,-3.0888783630162955,0.2013073133762795,-2.991133004926109,0.5907161803713521,0.13921940128836674,1.694050776809397,0.9004168245547568
2017,146,1376,77,1196,70,N,0,7,7,4,3,-1,-7,-3,2.2494047619047635,0.3136904761904731,0.6869047619047617,0.8839285714285694,-0.46250000000000036,-1.5107142857142861,-1.2369047619047624,2.0839285714285722,-0.10833333333333428,-1.9297619047619072,-0.5523809523809522,1.235119047619047,-2.5601190476190467
2017,152,1211,77,1376,73,N,0,4,1,7,-6,1,4,-6,4.478571428571428,-1.780059523809527,-0.9693452380952383,-2.3191964285714306,-0.03541666666666643,1.9736607142857139,-2.0546130952380945,5.818303571428572,0.4072916666666657,0.19002976190476062,-0.15654761904761827,-0.10342261904761907,-4.862202380952382
2017,152,1314,77,1332,76,N,0,1,1,3,-2,1,1,-2,3.058516483516481,6.1678571428571445,-1.3445054945054942,-4.083241758241758,0.8439560439560445,1.1431318681318672,3.7901098901098926,1.9266483516483532,3.4107142857142847,0.7409340659340664,-0.5076923076923077,-2.5151098901098896,1.5233516483516496
2017,154,1314,71,1211,65,N,0,6,1,1,0,-1,-6,0,-0.9835164835164818,-7.263392857142861,-1.4653159340659343,-2.132383241758241,2.023008241758241,5.205528846153847,-4.213770604395606,2.2309409340659343,-5.002232142857142,1.6550480769230766,1.584478021978022,-0.12997939560439598,-2.2153159340659343
2018,134,1347,71,1254,61,N,0,10,16,16,0,-1,-10,0,3.4894607843137244,3.006985294117655,0.3165441176470587,0.7871323529411747,3.2536764705882355,5.6346813725490215,-0.3560049019607856,4.3242647058823565,0.5384803921568633,2.015686274509804,-0.9024509803921568,0.24424019607843128,2.493259803921571
2018,134,1382,65,1417,58,N,0,7,11,11,0,1,7,0,-2.325714285714284,-3.6480519480519433,-1.8057142857142843,-4.786147186147186,2.6249350649350642,2.9954978354978365,0.869696969696971,-4.153766233766234,-1.1297835497835482,-0.6621645021645008,1.0712554112554118,-0.6244155844155843,1.8676190476190513
2018,135,1393,60,1113,56,N,0,4,11,11,0,-1,-4,0,5.188636363636363,6.123951048951042,2.9533216783216787,6.185489510489507,1.9312937062937063,2.9096153846153854,-2.1370629370629377,-0.2062937062937067,3.1452797202797207,-2.241083916083916,-0.6557692307692307,-1.9302447552447553,2.8937062937062947
2018,135,1411,64,1300,46,N,0,18,16,16,0,-1,-18,0,0.1098684210526315,-1.5324561403508739,-2.021271929824562,-3.6024122807017562,-6.451754385964911,-8.018530701754386,0.8314692982456151,-0.6859649122806992,2.2507675438596504,1.709758771929824,-0.9690789473684216,-0.622478070175438,1.9513157894736821
2018,136,1104,86,1439,83,N,0,3,9,8,1,1,3,1,-2.4357484620642538,-0.9733424470266527,-2.163795853269537,-2.896195033037138,1.4674413305992253,2.8288220551378416,2.7973342447026663,1.1462975620870353,-3.4128958760537706,1.858077010708591,0.7899749373433593,3.301549327865118,2.9256778309409874
2018,136,1138,89,1112,68,N,0,21,13,4,9,-1,-21,-9,-0.9006613756613753,-5.882089947089952,-3.65170634920635,-8.388227513227513,2.6925529100529086,1.655965608465607,-0.8045105820105825,-0.09390211640211632,-1.445542328042329,-0.8719047619047622,-1.4655687830687834,0.4709920634920639,-4.191084656084659
2018,136,1181,89,1233,67,N,0,22,2,15,-13,1,22,-13,0.9574175824175839,-0.8692307692307679,-1.7601648351648347,-2.947527472527476,1.4706043956043935,2.0403846153846175,4.616483516483516,1.8956043956043978,0.30247252747252773,1.526923076923076,0.10439560439560402,2.1420329670329674,-1.258241758241759
2018,136,1196,77,1382,62,N,0,15,6,11,-5,1,15,-5,0.0840476190476167,2.4845238095238074,1.336666666666666,3.904761904761905,-3.9576190476190476,-4.655238095238094,-0.05119047619047734,-0.1835714285714296,-0.9949999999999992,-1.3638095238095254,0.2959523809523814,1.2840476190476187,-3.0342857142857156
2018,136,1211,68,1422,64,N,0,4,4,13,-9,1,4,-9,5.042261904761901,3.3077380952380935,-0.9380952380952383,-2.160119047619048,2.722619047619048,2.7910714285714295,-1.6660714285714278,4.866666666666667,1.5452380952380942,-1.1517857142857153,-1.3392857142857135,1.4476190476190478,-1.3202380952380963
2018,136,1222,67,1361,65,N,0,2,6,11,-5,1,2,-5,-0.09981684981685035,0.5408424908424934,1.1201465201465215,1.697802197802197,-1.0587912087912077,-1.2283882783882731,1.3278388278388285,-0.6567765567765562,0.1747252747252741,-0.3245421245421234,0.4382783882783885,-0.017948717948717885,4.006593406593407
2018,136,1242,76,1335,60,N,0,16,1,16,-15,1,16,-15,2.810314584771106,1.08462732919255,1.2268518518518512,1.0306964573268935,-1.784952265930528,-3.519740625718889,1.1277605244996565,-3.1912382102599466,1.6625546353807223,1.0304807913503566,0.4732861743731309,0.9813089487002529,-1.588293650793652
2018,136,1246,78,1172,73,N,0,5,5,12,-7,-1,-5,7,0.4882575757575758,-0.8544913419913414,5.365584415584416,12.057088744588743,-5.2071428571428555,-9.8357683982684,-5.126406926406926,-0.6693722943722946,3.646536796536795,-3.3738095238095234,-0.9580086580086578,-2.628084415584416,-3.7919913419913414
2018,136,1260,64,1274,62,N,0,2,11,6,5,1,2,5,-2.370370370370374,-8.412457912457917,-1.007407407407407,-4.4505050505050505,0.7318181818181806,-0.20033670033670248,-4.147306397306397,0.1457912457912478,0.9141414141414135,1.4838383838383837,-0.32457912457912386,-1.119023569023569,-2.5895622895622896
2018,136,1276,61,1285,47,N,0,14,3,14,-11,1,14,-11,-0.34160052910053196,-2.3138227513227463,3.1259920634920633,6.877645502645503,-4.796296296296296,-5.479828042328041,-2.741071428571429,-1.146825396825399,1.511243386243386,-3.918320105820106,-2.267526455026456,-0.691137566137566,-4.999007936507937
2018,136,1326,81,1355,73,N,0,8,5,12,-7,1,8,-7,-0.375,-4.875,-3.5625,-8.541666666666671,-2.6666666666666643,-3.2708333333333357,0.6041666666666679,-2.4375,1.5416666666666679,1.4583333333333321,0.875,1.541666666666667,1.0625
2018,136,1348,83,1328,78,N,1,5,7,10,-3,-1,-5,3,2.8418315018315,3.2388156288156225,2.458046398046399,5.758888888888887,3.9633089133089108,3.2662515262515264,-1.2006959706959712,4.810354090354089,0.6611233211233216,2.235457875457877,-0.427948717948718,0.917069597069597,-2.1628205128205096
2018,136,1371,94,1301,83,N,0,11,8,9,-1,-1,-11,1,0.331168831168835,0.3722943722943768,0.30086580086580117,0.6212121212121211,0.05627705627705737,0.0692640692640687,0.108225108225108,-2.83549783549784,-0.06277056277055948,-0.19480519480519476,1.3831168831168839,0.108225108225108,0.20129870129870397
2018,136,1397,73,1460,47,N,0,26,3,14,-11,1,26,-11,0.7161352657004834,1.3209541062801975,0.9652777777777777,0.6997463768115963,1.3050966183574886,0.8632971014492732,2.11987922705314,-2.0724396135265692,2.019939613526569,-1.0378260869565228,-0.3665942028985505,2.039347826086956,4.218780193236714
2018,136,1403,70,1372,60,N,0,10,3,14,-11,-1,-10,11,1.3055555555555536,1.7986111111111143,-0.18055555555555625,-0.8263888888888893,1.0486111111111125,1.0972222222222214,-0.20833333333333393,-2.3611111111111107,-1.583333333333334,2.791666666666668,2.3611111111111107,-1.5277777777777777,4.243055555555557
2018,136,1437,87,1347,61,N,0,26,1,16,-15,-1,-26,15,-7.741666666666667,-7.933333333333337,-2.6833333333333327,-8.058333333333334,0.01666666666666572,0.6500000000000021,2.1333333333333346,-3.3583333333333343,-3.316666666666668,1.8083333333333336,0.4249999999999998,-0.8583333333333334,-0.4833333333333343
2018,137,1120,62,1158,58,N,0,4,4,13,-9,1,4,-9,0.28238095238095084,4.2354761904761915,1.5898809523809527,6.118809523809524,3.6758333333333333,4.437023809523808,3.6020238095238106,1.3110714285714309,2.514166666666666,2.0459523809523823,1.4345238095238093,1.1572619047619046,2.597619047619048
2018,137,1139,79,1116,62,N,0,17,10,7,3,-1,-17,-3,-0.6229325022803316,-1.7211614472484058,-0.7258437214958953,-3.977743995135299,2.255183946488293,5.811051991486771,0.824657950744907,-0.6548723016114337,0.11840224992398873,-0.2281924597141991,-0.7984873821830343,1.6718987534204919,1.7778048038917618
2018,137,1153,68,1209,53,N,0,15,2,15,-13,1,15,-13,-1.2287878787878803,-1.3356060606060538,-2.4795454545454554,-3.7280303030303017,2.418939393939393,2.846212121212119,3.2280303030303035,-1.4022727272727273,0.7681818181818176,1.0628787878787875,-0.02954545454545432,1.4469696969696972,-1.403030303030306
2018,137,1155,79,1308,68,N,0,11,5,12,-7,1,11,-7,-3.163574879227049,-5.306763285024154,0.5330434782608693,0.9669565217391316,2.374299516908213,0.7643478260869578,-2.535555555555556,0.07729468599033851,-1.304444444444444,1.5935265700483097,0.01062801932367119,1.9869565217391307,-1.7494685990338148
2018,137,1199,67,1281,54,N,0,13,9,8,1,1,13,1,4.511921850079748,7.996531100478478,-1.6723684210526315,-1.9760765550239228,-0.12727272727272876,1.4482456140350877,1.9539074960127607,-0.9222886762360432,1.4430622009569394,-1.2258771929824555,1.5018740031897924,1.1520334928229667,0.19118819776714346
2018,137,1243,69,1166,59,N,0,10,9,8,1,-1,-10,-1,4.763636363636358,6.665909090909082,3.134090909090909,6.713636363636361,-1.15909090909091,-1.7340909090909093,-0.9795454545454554,5.695454545454545,3.586363636363636,-0.6431818181818194,-2.2954545454545467,-0.5500000000000003,-3.322727272727274
2018,137,1267,81,1455,75,N,0,6,13,4,9,1,6,9,0.8899378881987552,1.7577018633540291,1.824782608695653,4.91223602484472,0.3740993788819864,-0.2696894409937869,-4.563788819875776,-0.9831677018633584,-0.8011180124223607,1.4452173913043485,2.3714906832298137,2.3977639751552795,0.3302484472049727
2018,137,1277,82,1137,78,N,0,4,3,14,-11,-1,-4,11,0.695498084291188,3.142969348659001,0.43352490421455947,2.806053639846745,1.575229885057471,3.937298850574713,-0.8645785440613025,-1.199731800766287,-3.6443869731800795,-0.8289463601532567,1.83595785440613,-2.6159003831417618,-0.07752873563218188
2018,137,1305,87,1400,83,N,1,4,7,10,-3,1,4,-3,2.2866193260930103,2.3765664160400988,2.0515176830966304,1.9687412976886662,3.6734892787524345,2.878167641325536,-1.485658590921748,0.8804650515176817,3.7136591478696737,-1.4445836814257866,0.26232247284878873,-1.1604010025062657,2.080966304650513
2018,137,1314,84,1252,66,N,0,18,2,15,-13,-1,-18,13,-1.3588888888888881,-2.363333333333344,-0.8016666666666659,0.16999999999999815,3.9627777777777773,6.042222222222222,-3.241666666666667,-0.14611111111111086,-3.1383333333333354,3.099444444444444,0.583333333333333,-1.4094444444444445,5.533333333333335
2018,137,1345,74,1168,48,N,0,26,2,15,-13,-1,-26,13,-1.8578643578643614,-3.2146464646464707,-3.4354256854256846,-6.917568542568542,3.0631313131313114,4.765151515151516,0.6204906204906209,-1.7341269841269842,-3.2429653679653683,3.6239177489177496,0.9787157287157289,-0.9013347763347768,2.564574314574312
2018,137,1393,57,1395,52,N,0,5,11,6,5,1,5,5,-7.313744588744591,-6.389102564102558,-2.5312437562437555,-2.9442557442557415,1.8761738261738277,1.526748251748252,0.28955211455211405,0.3420079920079928,-7.810539460539463,0.1795038295038296,0.6100982350982358,1.9471278721278722,-1.0476023976023967
2018,137,1401,73,1344,69,N,0,4,7,10,-3,-1,-4,3,-1.8603479853479854,-2.449542124542127,-0.2266483516483513,-0.9556776556776541,3.028479853479853,3.3877289377289372,-1.6582417582417577,-3.314560439560438,-1.1665750915750905,-1.0133699633699642,1.2341575091575097,-2.180677655677656,1.2064102564102583
2018,137,1420,74,1438,54,N,0,20,16,1,15,1,20,15,1.9268049155145874,4.575192012288788,0.9960829493087555,1.8592933947772678,0.586021505376344,3.0278801843317975,1.4712749615975405,-0.6184331797235032,1.0443932411674357,3.1186635944700463,0.9692780337941631,-0.877572964669739,2.662980030721968
2018,137,1452,85,1293,68,N,0,17,5,12,-7,-1,-17,7,-1.6458333333333357,-6.725000000000001,-0.8833333333333346,-3.195833333333333,0.2833333333333332,1.4541666666666657,-2.9833333333333325,3.029166666666665,-1.3583333333333325,1.1208333333333336,-1.2749999999999986,-1.5374999999999996,-3.875
2018,137,1462,102,1411,83,N,0,19,1,16,-15,-1,-19,15,-1.9723684210526287,-1.0032581453634037,1.1504385964912283,1.3613408521303256,0.9946115288220518,3.551566416040103,0.10870927318295642,-1.0878446115288227,-2.829636591478696,-0.08208020050125242,0.6244360902255641,1.6352756892230573,-0.12988721804511272
2018,138,1181,87,1348,62,N,0,25,2,7,-5,1,25,-5,2.6806593406593393,-0.42571428571428527,0.9968131868131866,1.7051648351648296,3.093956043956041,2.742747252747254,1.495274725274724,4.445274725274725,2.024065934065934,2.126483516483516,-0.25945054945054924,1.5700000000000003,-3.0043956043956044
2018,138,1211,90,1326,84,N,0,6,4,5,-1,1,6,-1,3.5333333333333314,5.1499999999999915,2.049999999999999,6.616666666666667,0.716666666666665,0.6958333333333364,1.0124999999999993,2.054166666666667,1.2833333333333314,-0.20833333333333215,-0.02083333333333215,0.6083333333333334,0.48333333333333073
2018,138,1242,83,1371,79,N,0,4,1,8,-7,1,4,-7,0.9817219817219822,-0.1666666666666643,2.072631072631072,5.632275132275133,-3.3085618085618087,-4.809042809042811,-1.8145743145743136,-1.7758537758537756,0.8205868205868221,-0.39225589225589275,0.39345839345839373,0.22029822029821977,-1.5901875901875897
2018,138,1246,95,1138,75,N,0,20,5,13,-8,-1,-20,8,3.270833333333332,6.755833333333335,4.7525,11.520833333333332,-3.2991666666666646,-4.484999999999999,-0.3108333333333331,-0.7308333333333366,3.4674999999999994,-0.4066666666666663,0.7158333333333333,-0.620000000000001,2.418333333333333
2018,138,1260,63,1397,62,N,0,1,11,3,8,1,1,8,-0.8570370370370384,-7.858796296296298,-0.9726851851851848,-3.3147222222222226,-4.031666666666666,-4.753796296296297,-6.452407407407407,1.314629629629632,-1.5102777777777785,0.40111111111111164,0.280925925925926,-1.4424074074074067,-6.449537037037038
2018,138,1276,64,1222,63,N,0,1,3,6,-3,-1,-1,3,0.8578551078551087,3.4802604802604833,-0.10286935286935162,-1.1381766381766383,2.5398860398860403,2.4067969067969095,2.95879120879121,2.2686202686202677,0.9480056980056979,2.564611314611316,0.5814000814000817,0.18152218152218147,5.509768009768006
2018,138,1403,69,1196,66,N,0,3,3,6,-3,-1,-3,3,0.4180555555555543,3.94027777777778,1.8652777777777771,4.219444444444445,-0.8013888888888889,-1.656944444444445,-0.6333333333333329,-0.5777777777777793,-1.4499999999999993,-2.854166666666668,0.16527777777777786,0.2013888888888884,-0.7777777777777786
2018,138,1437,81,1104,58,N,0,23,1,9,-8,-1,-23,8,-5.852631578947371,-8.139035087719293,-3.9372807017543856,-10.248684210526314,3.0679824561403493,6.694298245614036,1.2780701754385966,-0.1434210526315809,-2.7429824561403517,3.696929824561405,0.30307017543859693,1.6192982456140355,1.4271929824561411
2018,139,1155,84,1120,53,N,0,31,5,4,1,-1,-31,-1,1.4778605935127658,6.51247757073844,1.0012422360248454,3.775900621118012,5.902843340234643,6.564223602484471,3.3926984126984134,-0.8287232574189076,0.7473015873015871,-0.6449551414768795,1.3036576949620429,0.21018633540372633,3.958040027605243
2018,139,1199,75,1462,70,N,0,5,9,1,8,1,5,8,0.37727272727272876,2.227922077922088,0.9500000000000002,2.4782467532467507,-2.6344155844155885,-0.3857142857142861,1.8577922077922082,-1.3048701298701282,-0.7620129870129837,0.4214285714285708,1.3587662337662332,2.7561688311688313,0.8077922077922075
2018,139,1243,50,1420,43,N,0,7,9,16,-7,1,7,-7,0.480086580086585,-3.5517316017315963,-2.820129870129871,-5.651082251082251,2.3560606060606055,1.255844155844155,-1.408225108225107,-1.5428571428571445,-0.5839826839826845,0.10714285714285765,0.6179653679653683,0.30865800865800885,2.122943722943724
2018,139,1305,75,1153,73,N,0,2,7,2,5,-1,-2,-5,-2.8195767195767196,-5.027380952380952,-2.4490740740740744,-4.059656084656083,-1.7712962962962955,-0.7030423280423292,2.545370370370369,-2.9419312169312164,-2.216666666666667,2.072089947089946,0.7908730158730162,1.9952380952380953,-0.75026455026455
2018,139,1345,76,1139,73,N,0,3,2,10,-8,-1,-3,8,2.7592490842490847,6.125641025641023,-0.31739926739926716,0.9889194139194153,-2.443589743589744,-3.757692307692306,1.3054945054945062,-2.752289377289376,-1.4170329670329682,0.04413919413919487,1.5332417582417577,-1.3763736263736268,2.3620879120879117
2018,139,1393,55,1277,53,N,0,2,11,3,8,-1,-2,-8,4.6517241379310335,2.5083554376657844,1.6218169761273202,2.444031830238721,-1.0165119363395245,-1.834350132625996,-1.5254641909814328,2.5432360742705598,6.961737400530506,0.6151856763925743,-3.5928381962864724,1.1391909814323604,3.1854774535809014
2018,139,1401,86,1314,65,N,0,21,7,2,5,-1,-21,-5,1.3116666666666639,3.6883333333333397,1.8849999999999998,3.3466666666666676,0.48166666666666735,-1.120000000000001,1.2333333333333343,-0.5816666666666634,2.3383333333333347,-1.3966666666666665,0.10833333333333339,-1.7683333333333335,-0.9333333333333336
2018,139,1452,94,1267,71,N,0,23,5,13,-8,-1,-23,8,1.2998188405797073,-2.1483695652173935,1.388949275362318,3.160688405797103,1.1077898550724647,1.5467391304347835,-6.602717391304348,4.265760869565213,2.4634057971014514,1.819384057971014,-0.6789855072463755,0.8893115942028986,-3.711775362318839
2018,143,1199,75,1211,60,N,0,15,9,4,5,1,15,5,-1.756060606060604,-0.2280303030302946,-0.7333333333333325,-2.3515151515151516,1.3643939393939384,3.224999999999998,1.5696969696969703,-1.7143939393939398,-0.5727272727272705,0.75,0.6575757575757564,0.6621212121212121,0.06969696969697026
2018,143,1243,61,1246,58,N,0,3,9,5,4,1,3,4,-1.1859848484848463,-2.792803030303027,1.7227272727272727,5.1685606060606055,-2.7439393939393923,-5.460227272727273,-3.76060606060606,-4.458333333333336,0.963636363636363,-1.5166666666666657,2.3060606060606066,-1.894318181818182,-0.798484848484847
2018,143,1260,69,1305,68,N,0,1,11,7,4,1,1,4,-3.923280423280424,-10.415343915343918,-2.359259259259259,-6.540211640211638,-4.829629629629629,-5.791005291005291,-3.203703703703705,-1.187301587301583,-1.9444444444444446,2.3248677248677243,-0.2582010582010579,-0.9455026455026454,-4.22063492063492
2018,143,1276,99,1401,72,N,0,27,3,7,-4,1,27,-4,-1.1183862433862473,-3.2906084656084644,2.2361111111111107,4.416931216931218,-2.2641534391534393,-3.116137566137567,-2.9952380952380953,-5.414682539682538,-1.1649470899470913,-4.393915343915344,0.24616402116402103,-3.0673280423280422,-0.4865079365079339
2018,144,1181,69,1393,65,N,0,4,2,11,-9,1,4,-9,6.9228021978021985,6.055769230769229,1.7667582417582413,3.4774725274725213,-1.2120879120879149,-1.1019230769230752,1.1684065934065941,2.0456043956043963,5.358241758241757,0.6692307692307686,-0.4052197802197801,-0.24258241758241716,-0.06978021978022042
2018,144,1242,80,1155,76,N,0,4,1,5,-4,-1,-4,4,-4.96399815965033,-6.092477570738438,-1.438808373590982,-2.7834138486312376,2.848056130664826,2.777892799631932,-1.2539682539682548,1.939728548424199,-3.8624338624338623,0.7352196917414311,-0.8724407637451117,0.8991258339084434,-0.07867494824016319
2018,144,1403,78,1345,65,N,0,13,3,2,1,-1,-13,-1,0.6716269841269842,-0.5347222222222143,1.4890873015873005,2.158730158730158,0.04861111111111249,-1.5902777777777786,-3.553571428571429,2.609126984126984,1.1785714285714288,-1.6220238095238102,-1.4692460317460316,-0.02480158730158699,-2.170634920634921
2018,144,1437,90,1452,78,N,0,12,1,5,-4,1,12,-4,3.404166666666665,-1.0791666666666657,1.4624999999999986,4.662500000000001,-1.7708333333333321,-2.2166666666666686,-5.304166666666667,3.3458333333333314,0.6250000000000018,-1.0374999999999996,-1.174999999999999,-1.1875,-4.029166666666669
2018,145,1260,78,1243,62,N,0,16,11,9,2,-1,-16,-2,1.1052188552188582,3.682659932659938,0.05791245791245725,2.6449494949494934,1.6393939393939405,1.7735690235690242,2.180134680134681,-2.779629629629632,0.3914141414141419,-0.7111111111111104,1.546801346801347,0.025589225589225606,4.655218855218857
2018,145,1276,58,1199,54,N,0,4,3,9,-6,-1,-4,6,2.312325637325639,4.512578162578166,-0.8361111111111104,-1.8684463684463708,4.478547378547377,5.841137566137565,2.4899350649350662,3.275288600288601,1.050553150553153,3.677248677248677,0.6780784030784028,2.3544492544492543,2.1145382395382377
2018,146,1242,85,1181,81,N,1,4,1,2,-1,-1,-4,1,-0.08262108262108114,-0.7857142857142847,-1.6293243793243786,-3.785205535205538,4.336284086284085,5.262006512006515,2.9911477411477403,2.8734228734228715,-0.4482091982091987,1.1024623524623518,0.4174806674806675,1.4907407407407414,0.04639804639804623
2018,146,1437,71,1403,59,N,0,12,1,3,-2,-1,-12,2,-5.459722222222222,-6.6569444444444485,-3.3069444444444436,-9.994444444444444,2.259722222222221,4.931944444444447,2.841666666666667,-1.6055555555555543,-1.208333333333334,2.3791666666666664,0.5180555555555557,0.49027777777777803,0.62777777777778
2018,152,1276,69,1260,57,N,0,12,3,11,-8,-1,-12,8,-2.1269841269841265,-5.9973544973545,-1.8962962962962955,-6.672486772486771,1.239153439153439,0.2698412698412689,-3.4788359788359786,1.9026455026455054,-0.3544973544973544,3.3883597883597876,0.5380952380952388,0.0015873015873015817,-2.233862433862436
2018,152,1437,95,1242,79,N,0,16,1,1,0,-1,-16,0,-1.5195767195767225,-2.0726190476190496,-0.9064814814814817,-4.137962962962963,-1.9720899470899482,-1.1318783068783063,1.4150793650793663,-1.8707671957671934,1.3346560846560838,2.0699735449735446,0.22473544973544968,-0.07883597883597915,-1.3007936507936506
2018,154,1437,79,1276,62,N,0,17,1,3,-2,-1,-17,2,-4.710052910052912,-6.157275132275132,-1.6472222222222221,-5.458068783068782,-1.9641534391534403,-0.22447089947089793,0.788095238095238,-3.3813492063492063,-1.506613756613758,-0.9855820105820108,-0.3705026455026461,-0.9756613756613755,-1.2531746031745996
2019,134,1125,81,1396,70,N,0,11,11,11,0,1,11,0,4.818067632850237,6.345990338164249,2.0845410628019323,6.935942028985508,-1.925217391304347,-3.474879227053137,-0.6548792270531401,4.589758454106281,4.380772946859901,-0.259227053140096,-1.72415458937198,1.6689855072463766,-1.3700483091787454
2019,134,1192,82,1341,76,N,0,6,16,16,0,1,6,0,0.6410256410256387,-3.6043956043955987,1.6121794871794872,-0.025335775335776134,-2.7765567765567774,-5.527777777777775,-2.1047008547008534,1.0830280830280827,2.178113553113553,0.4800061050061064,-1.055708180708181,2.0541819291819294,-4.806166056166056
2019,135,1113,74,1385,65,N,0,9,11,11,0,1,9,0,-1.7673160173160163,-1.5467532467532479,-1.0726190476190478,-1.7627705627705623,4.486580086580087,8.26525974025974,4.7623376623376625,3.1029220779220807,-0.8179653679653676,3.2636363636363637,-2.4922077922077914,-0.14599567099567112,0.31926406926407225
2019,135,1295,78,1300,74,N,0,4,16,16,0,1,4,0,0.28541666666667,-0.17083333333333428,3.427083333333333,6.302083333333332,0.4645833333333318,-0.8604166666666693,-4.925,-0.8166666666666664,-3.125,-4.81875,-0.5291666666666677,-0.08333333333333304,-2.864583333333332
2019,136,1120,78,1308,77,N,0,1,5,12,-7,1,1,-7,1.1130952380952337,-0.0027777777777799884,3.2457142857142864,2.749920634920638,-1.0937301587301604,-3.1773015873015886,-3.2858730158730154,-1.8612698412698379,0.7120634920634927,1.3280158730158735,2.7207142857142843,2.0743650793650796,1.0597619047619027
2019,136,1124,78,1393,69,N,0,9,9,8,1,1,9,1,1.8566801619433235,1.7765182186234796,-0.1581983805668008,-0.9263157894736871,-1.3646761133603231,-1.956376518218626,2.6096153846153847,1.157995951417,1.8553643724696371,0.8263157894736821,-2.1397773279352226,-0.05091093117408896,1.4384615384615387
2019,136,1196,70,1305,61,N,0,9,10,7,3,1,9,3,-0.9393829401088922,-3.0191923774954574,0.5484724742891709,-0.08496672716273324,-3.6756200846944953,-6.986539624924379,0.689065335753174,-5.397640653357534,-0.15545977011494294,0.459180278281913,1.3732002419842706,-0.7572444041137327,-1.776905626134301
2019,136,1199,76,1436,69,N,0,7,4,13,-9,1,7,-9,0.8264143264143264,3.231786731786727,-0.46092796092796107,-0.348188848188844,0.5440577940577942,1.8669108669108674,3.1658526658526664,0.06481481481481666,1.253968253968253,1.9301994301994299,2.0021367521367512,1.3528693528693525,1.7483719983719972
2019,136,1211,87,1192,49,N,0,38,1,16,-15,-1,-38,15,-3.2756410256410255,-3.1615384615384556,0.9038461538461533,-0.7491452991452974,-0.9884615384615376,-1.0111111111111093,0.9119658119658123,-3.4264957264957303,-1.7397435897435898,2.3311965811965827,0.04786324786324858,-0.5970085470085471,0.5081196581196572
2019,136,1242,87,1318,53,N,0,34,4,13,-9,1,34,-9,0.9656038647342982,4.617342995169082,-2.751787439613527,-4.785362318840576,-0.8945893719806755,-0.5032367149758485,3.261690821256039,2.7844444444444463,-1.9727536231884066,2.317681159420289,0.8459903381642517,1.41096618357488,0.7449275362318843
2019,136,1246,79,1101,44,N,0,35,2,15,-13,-1,-35,13,-1.5032206119162623,-1.3168276972624753,1.464170692431562,1.9412238325281805,-4.88204508856683,-6.2512077294686,-2.262077294685991,-4.661030595813205,-0.4496779388083727,0.23671497584540901,2.8888888888888893,-1.9210950080515303,2.4126409017713364
2019,136,1261,79,1463,74,N,0,5,3,14,-11,1,5,-11,-0.9120879120879124,0.8287545787545838,-0.6034798534798531,0.6263736263736277,4.48076923076923,6.126373626373628,5.335164835164836,-4.015567765567766,-3.0366300366300365,0.7261904761904763,2.5686813186813193,0.18315018315018294,1.4157509157509125
2019,136,1268,79,1125,77,N,0,2,6,11,-5,-1,-2,5,5.61545454545454,10.882727272727266,2.4000000000000004,9.024545454545454,-0.6554545454545462,-1.1272727272727252,-1.4754545454545447,1.149090909090912,5.146363636363635,-2.2618181818181817,2.877272727272727,-0.9327272727272726,1.0590909090909086
2019,136,1276,74,1285,55,N,0,19,2,15,-13,1,19,-13,-2.0119047619047628,1.1785714285714306,0.08333333333333393,1.8303571428571423,-1.8363095238095237,-3.3333333333333357,-1.3928571428571441,1.4285714285714306,-1.032738095238095,-3.7261904761904763,-0.3809523809523814,1.1369047619047614,-4.419642857142854
2019,136,1277,76,1133,65,N,0,11,2,15,-13,-1,-11,13,-3.9426691729323338,-2.7390350877192944,-1.5855263157894743,-2.5485588972431117,-1.3032581453634098,-1.1901629072681708,-1.0150375939849638,-4.349310776942357,-6.051691729323309,-1.2869674185463662,-0.10432330827067648,-2.2171052631578947,-0.09179197994987476
2019,136,1278,86,1257,76,N,0,10,10,7,3,-1,-10,-3,0.556684981684981,1.6945970695970658,3.6596153846153854,9.475091575091575,-0.05879120879120947,-3.0948717948717928,-1.0213369963369985,2.546428571428571,-1.1587912087912091,0.6342490842490847,-0.18113553113553138,-0.9347069597069604,1.4626373626373628
2019,136,1293,83,1266,64,N,0,19,12,5,7,-1,-19,-7,-2.434166666666666,-3.2694444444444457,1.5072222222222216,1.3194444444444429,0.37944444444444336,0.08083333333333442,-1.8261111111111106,2.474444444444444,-2.28638888888889,0.7986111111111107,-2.71638888888889,-0.25833333333333286,2.570277777777779
2019,136,1345,61,1330,48,N,0,13,3,14,-11,-1,-13,11,-3.2295150501672225,-3.664831846897073,-2.000487736900782,-5.315356744704573,-1.0206010776662957,0.11206335934596723,-0.8135916016350802,2.621887774061687,-1.9850891861761415,1.1661324786324787,-1.1362876254180598,0.7021785581568194,-1.4270252694165713
2019,136,1437,61,1388,57,N,0,4,6,11,-5,-1,-4,5,2.1757575757575722,0.7945454545454567,-3.391414141414142,-10.980808080808078,-1.5808080808080813,-2.390505050505052,-0.02474747474747474,0.20181818181817945,-4.038181818181817,-0.8213131313131328,0.5737373737373739,-0.737373737373737,-0.1479797979797972
2019,136,1459,84,1371,68,N,0,16,7,10,-3,-1,-16,3,-1.0673076923076934,-1.2788461538461604,-3.3576923076923064,-5.607692307692304,3.5173076923076927,5.1903846153846125,0.02307692307692122,1.5423076923076948,0.6923076923076916,0.8499999999999979,2.046153846153846,1.319230769230769,0.4134615384615401
2019,137,1138,91,1113,74,N,0,17,6,11,-5,-1,-17,5,-3.336363636363636,-5.2848484848484745,-3.1833333333333336,-8.065151515151516,1.4151515151515142,2.704545454545457,0.5742424242424242,-0.4196969696969681,-1.6227272727272712,0.6136363636363633,-0.49696969696969795,-0.5090909090909093,-0.3378787878787861
2019,137,1181,85,1295,62,N,0,23,1,16,-15,1,23,-15,4.665158045977009,11.420258620689651,-2.3730603448275858,-0.050359195402297274,2.269899425287356,4.41329022988506,7.195114942528737,3.9419540229885044,3.398563218390805,2.470474137931033,3.2969827586206906,4.578735632183908,1.3243534482758612
2019,137,1222,84,1209,55,N,0,29,3,14,-11,-1,-29,11,1.6755493221131346,-1.8709677419354804,0.3338787595449588,-1.3522674146797584,0.15334268349696067,0.36637057815178053,-4.46735234533271,-1.1925354527037548,-1.7360916316035535,1.8771232663238262,1.947171575502571,0.6742247155991885,-1.3865513479819214
2019,137,1234,79,1153,72,N,0,7,10,7,3,-1,-7,-3,-1.9393939393939377,-0.011904761904759198,-1.5508658008658003,-2.9908008658008676,-2.8030303030303045,-2.679112554112553,2.800324675324676,-3.0887445887445892,-3.0016233766233746,-1.5530303030303045,-0.13203463203463173,1.4090909090909092,0.341450216450216
2019,137,1251,80,1280,76,N,0,4,12,5,7,1,4,7,-0.8771014492753615,-2.3369565217391255,0.3060869565217388,1.690144927536231,-3.14463768115942,-6.010869565217389,-3.806521739130435,-0.8926086956521786,-0.24579710144927525,-1.8231884057971008,-2.1055072463768116,-2.3884057971014494,-0.4907246376811578
2019,137,1314,88,1233,73,N,0,15,1,16,-15,-1,-15,15,-2.99869281045752,-8.821241830065361,0.7397603485838786,1.0222222222222221,1.860021786492375,2.329084967320263,-4.2252723311546845,-3.001089324618736,-4.142156862745097,-0.3739651416121994,0.4647058823529404,-0.1581699346405232,-0.47810457516339966
2019,137,1326,62,1235,59,N,0,3,11,6,5,-1,-3,-5,3.9281999465065844,3.6593360872537133,0.6083538886742552,0.8715043537698008,-0.7546063776040892,-0.7727867098576517,0.2195087521174468,-0.2091518321495407,0.7661148919730181,-1.2909893310350977,0.9845240571785201,2.1297958334571607,-2.9227243008707546
2019,137,1328,95,1279,72,N,0,23,9,8,1,-1,-23,-1,0.6301282051282087,-0.21025641025641306,1.5260796221322543,3.7448380566801625,1.7707827260458835,0.17958839406207616,0.5617071524966253,-3.4530026990553324,1.4618421052631572,0.4594804318488528,0.9876518218623476,0.64251012145749,2.641464237516871
2019,137,1332,72,1458,54,N,0,18,12,5,7,1,18,7,-0.8380434782608681,-0.7818840579710127,0.9047101449275363,3.282246376811596,2.763768115942028,1.8315217391304355,1.9565217391304346,-2.6688405797101424,1.309057971014493,2.421376811594202,2.6728260869565217,-0.12101449275362341,2.692391304347826
2019,137,1397,77,1159,70,N,0,7,2,15,-13,-1,-7,13,-2.2883540372670765,-3.984782608695653,1.7336956521739122,3.239285714285714,-2.4990683229813655,-2.7989130434782616,-0.3131987577639741,-1.228881987577637,-0.7543478260869563,1.8006211180124208,0.9549689440993792,-1.1670807453416154,-2.799378881987579
2019,137,1403,72,1297,57,N,0,15,3,14,-11,-1,-15,11,2.3990384615384635,2.891025641025635,1.9855769230769234,4.801282051282051,0.12820512820512775,1.5256410256410255,1.9358974358974343,-0.3044871794871753,4.698717948717945,-0.799679487179489,-2.238782051282051,-0.7035256410256405,2.161858974358978
2019,137,1414,70,1243,64,N,0,6,13,4,9,-1,-6,-9,-2.915344827586207,-3.059482758620689,0.939051724137931,2.5162068965517257,-2.009913793103447,-1.2958620689655191,-1.115258620689655,-3.793965517241382,1.1225000000000005,-0.535172413793104,1.8608620689655169,-1.5188793103448273,-3.638017241379309
2019,137,1416,73,1433,58,N,0,15,9,8,1,1,15,1,-0.11431677018633479,-3.838431677018633,0.14899068322981357,-3.347468944099383,-0.001708074534160886,1.7766149068322967,-1.2429968944099379,-0.46895962732919116,0.05240683229813747,-1.7429503105590047,-1.4834316770186335,-0.26229813664596247,-3.0004658385093137
2019,137,1438,71,1205,56,N,0,15,1,16,-15,-1,-15,15,0.16598746081504956,0.324164054336471,0.3970219435736686,-0.3914054336468169,4.754832810867292,7.078474399164055,-2.082732497387669,3.262748171368859,0.2700888192267499,2.6867554858934177,0.4904127481713694,-1.3516718913270633,0.42437304075235005
2019,137,1439,66,1387,52,N,0,14,4,13,-9,-1,-14,9,-0.6231884057971016,4.276268115942024,-3.3686594202898563,-5.399456521739133,0.45018115942028913,5.14039855072464,5.595108695652174,2.447463768115945,-1.6222826086956523,1.4800724637681135,0.23278985507246386,1.6358695652173916,2.883152173913043
2019,137,1449,78,1429,61,N,0,17,9,8,1,-1,-17,-1,1.7094017094017104,2.8860398860398817,-0.3324430199430193,-0.49376780626780814,3.7824074074074083,3.768518518518519,1.1924857549857553,6.9643874643874675,3.5824430199430193,0.13888888888888928,-2.752314814814815,-1.0544871794871806,0.3783831908831914
2019,138,1120,89,1242,75,N,0,14,5,4,1,1,14,1,-0.25111111111111484,1.224444444444444,3.942222222222223,8.544444444444444,0.6466666666666647,0.7644444444444431,1.097777777777777,-4.859999999999999,1.344444444444445,-1.0888888888888886,1.9444444444444429,0.7377777777777776,1.7466666666666661
2019,138,1199,90,1293,62,N,0,28,4,12,-8,1,28,-8,-3.721534391534391,-2.5835978835978892,-0.611825396825397,-0.8161375661375629,1.1585449735449718,0.9012698412698441,0.21687830687830711,-0.4885185185185179,-3.66436507936508,0.3148148148148149,-0.5288888888888899,0.8765873015873016,2.8854232804232787
2019,138,1211,83,1124,71,N,0,12,1,9,-8,-1,-12,8,-3.9625506072874472,-0.7529689608636971,0.8103913630229416,2.9595816464237537,-2.4037786774628884,-1.2326585695006749,5.061538461538461,-1.809311740890692,-2.0747638326585687,2.3147773279352215,-1.2840080971659908,0.3420377867746289,2.708974358974359
2019,138,1246,62,1459,56,N,0,6,2,7,-5,1,6,-5,-1.0762108262108256,-4.602207977207982,-4.617877492877492,-10.370014245014243,7.4971509971509995,9.882478632478634,0.7094017094017104,2.836894586894587,1.7076210826210811,1.0085470085470085,0.1976495726495724,1.9152421652421658,-0.9943019943019955
2019,138,1261,69,1268,67,N,0,2,3,6,-3,1,2,-3,3.2262237762237724,5.908624708624707,-0.13205128205128158,1.4737762237762233,4.851981351981351,6.375291375291376,2.796853146853149,-2.758857808857808,0.20687645687645784,1.0348484848484834,4.622144522144523,-0.5086247086247084,3.679603729603727
2019,138,1276,64,1196,49,N,0,15,2,10,-8,-1,-15,8,-0.8973057644110263,-0.8917293233082688,0.35307017543859587,0.9790726817042632,1.662844611528822,2.280701754385966,3.091979949874686,-2.458395989974939,-0.6047619047619044,2.7586466165413537,1.2182330827067664,-0.19874686716792,1.5299498746867144
2019,138,1277,70,1278,50,N,0,20,2,10,-8,1,20,-8,2.625915750915752,-0.2898351648351678,3.375,5.049908424908423,-0.6172161172161186,-2.2367216117216095,-1.2353479853479854,3.9391025641025657,3.6195054945054945,2.1849816849816843,0.7696886446886451,1.9922161172161168,1.8951465201465219
2019,138,1345,87,1437,61,N,0,26,3,6,-3,1,26,-3,2.505797101449275,5.125024154589383,-0.6763285024154584,-2.7502415458937186,-2.1594202898550723,-2.4269565217391325,2.315942028985507,-0.3326570048309172,0.678550724637681,-1.217777777777778,1.103381642512077,0.3913043478260869,0.33236714975845416
2019,139,1181,77,1416,76,N,0,1,1,9,-8,1,1,-8,5.494415292353821,13.435476011993998,0.3288418290854569,6.26205022488756,0.8790479760119929,-0.9018365817091407,4.300730884557723,2.7732946026986482,2.2259182908545725,0.48324587706146716,2.412200149925038,2.572938530734632,-0.8492878560719674
2019,139,1222,74,1326,59,N,0,15,3,11,-8,1,15,-8,0.7658258549599815,4.244401325895389,1.2064031045355321,3.976736195327028,-1.0271848977281905,0.933745654458729,3.2615207373271886,0.09647101625030174,-0.7968712102837721,-2.4278842266957703,-0.3282601665453946,1.6009378284420732,0.8008933624383552
2019,139,1314,81,1449,59,N,0,22,1,9,-8,1,22,-8,5.20940170940171,12.645299145299148,0.6582977207977212,1.9043803418803407,1.5787037037037024,1.0277777777777786,3.859152421652423,7.269943019943021,5.850961538461538,-0.9074074074074083,-2.104166666666666,-2.276709401709402,-0.8530982905982896
2019,139,1332,73,1414,54,N,0,19,12,13,-1,1,19,-1,-0.4896926536731634,-1.9772363818090923,1.7925662168915544,3.79236631684158,-0.9956021989005492,-0.9508620689655203,-1.1001499250374813,-2.703023488255873,2.0003623188405797,0.01185657171414256,2.0226011994002997,0.23325837081459255,-1.6209520239880035
2019,139,1397,83,1234,77,N,1,6,2,10,-8,-1,-6,8,-3.230844155844153,-3.049999999999997,0.4068181818181813,1.4574675324675326,3.0720779220779235,4.988636363636363,0.19253246753246778,-1.5707792207792188,-0.9090909090909101,0.04350649350649327,1.0344155844155836,-1.3305194805194809,-2.6474025974025963
2019,139,1403,78,1138,58,N,0,20,3,6,-3,-1,-20,3,4.328205128205127,9.807692307692292,3.7064102564102566,9.984615384615385,3.0448717948717956,5.175641025641024,3.2192307692307693,2.6705128205128226,2.4320512820512796,-0.4205128205128208,-0.8679487179487175,-0.8076923076923075,2.524358974358975
2019,139,1438,63,1328,51,N,0,12,1,9,-8,-1,-12,8,-0.3315649867374013,3.7033598585322736,-0.8964819209828283,-1.9635162175997039,1.6378379636092895,3.234492065708036,0.24949974405509856,5.933175112848431,-0.369026013309135,2.7166689934385033,0.21867001721811175,-0.7896365582390987,-0.30496998464330716
2019,139,1439,67,1251,58,N,0,9,4,12,-8,-1,-9,8,1.8866666666666703,3.2708333333333286,-0.42416666666666814,0.4591666666666683,-2.4075000000000006,-3.4124999999999996,-0.46250000000000036,0.14833333333333343,-0.8691666666666666,0.19166666666666643,-0.9658333333333333,0.3250000000000002,1.9224999999999994
2019,143,1211,72,1199,58,N,0,14,1,4,-3,-1,-14,3,-5.1415343915343925,-0.6669312169312178,0.2698412698412689,2.1505291005291056,0.9402116402116398,1.2746031746031754,3.4068783068783066,-1.7185185185185219,-3.6460317460317455,2.064814814814815,-0.8388888888888886,0.5849206349206346,3.297089947089944
2019,143,1345,99,1397,94,N,1,5,3,2,1,1,5,1,-2.514440993788817,0.2350241545893823,2.32644927536232,6.733488612836439,-2.279261559696341,-1.684178743961354,2.2377674258109046,-2.5597998619737723,-2.10144927536232,-1.6484126984126988,1.4049689440993784,-0.9745686680469294,-1.3716011042098017
2019,143,1403,63,1276,44,N,0,19,3,2,1,-1,-19,-1,-0.008699633699635001,1.3195970695970658,1.1314102564102573,3.6941391941391934,-2.270604395604396,-3.2243589743589745,-1.123626373626374,0.0824175824175839,0.7701465201465183,-4.296703296703297,-1.7239010989010985,-0.6291208791208791,-2.0494505494505475
2019,143,1438,53,1332,49,N,0,4,1,12,-11,-1,-4,11,-0.9724512743628182,2.383683158420787,0.23394552723638196,1.6624812593703133,1.3020989505247371,2.1307471264367805,0.702148925537232,2.1877811094452753,0.7681784107946026,2.6015117441279365,2.003060969515242,0.22751124437781112,2.0893928035982015
2019,144,1120,97,1314,80,N,0,17,5,1,4,1,17,4,-2.888888888888893,-6.3500000000000085,2.9507407407407413,5.40666666666667,-0.9581481481481475,-0.8122222222222248,-1.5014814814814823,-6.557037037037034,-3.7522222222222226,0.18185185185185304,2.226666666666665,1.3977777777777778,1.3077777777777762
2019,144,1181,75,1439,73,N,0,2,1,4,-3,1,2,-3,4.80057471264368,12.453591954022983,-1.533477011494254,2.4142241379310363,3.0303160919540204,5.323706896551727,4.9909482758620705,5.266954022988507,0.6443965517241388,1.6100574712643656,1.2219827586206904,4.853735632183908,1.3889367816091926
2019,144,1246,62,1222,58,N,0,4,2,3,-1,-1,-4,1,-1.497610513739545,3.130227001194747,3.0964755077658292,9.221027479091997,-5.633213859020312,-5.2383512544802855,1.4202508960573468,-1.1762246117084842,-0.9889486260453992,-2.6379928315412187,0.5286738351254492,-0.4805854241338112,1.5298685782556767
2019,144,1277,80,1261,63,N,0,17,2,3,-1,-1,-17,1,0.85576923076923,4.929945054945058,-1.407051282051282,1.0251831501831496,3.1712454212454215,3.2751831501831496,3.5851648351648358,-4.604853479853482,-5.1616300366300365,0.39285714285714235,3.205586080586081,-1.8108974358974361,1.3264652014651972
2019,145,1403,75,1211,69,N,0,6,3,1,2,-1,-6,-2,4.628205128205128,3.1743589743589666,0.2564102564102573,0.5846153846153825,2.411538461538461,2.342307692307692,-0.24743589743589745,1.1871794871794918,3.5987179487179475,-2.070512820512821,-0.10128205128205181,-0.3410256410256407,-1.1256410256410234
2019,145,1438,80,1345,75,N,1,5,1,3,-2,-1,-5,2,0.4460269865067481,6.911460936198573,2.239380309845079,6.450524737631184,1.210311510911211,2.1965683824754265,3.6465933699816766,1.9691820756288507,1.2663668165917024,0.978927203065135,0.7041479260369812,-0.30026653339996656,1.666083624854238
2019,146,1120,77,1246,71,N,1,6,5,2,3,1,6,3,0.18518518518518334,3.7148148148148152,5.395185185185186,12.64740740740741,-5.078518518518521,-6.340000000000003,0.22999999999999865,-4.316296296296294,-0.6040740740740738,0.24666666666666615,3.448888888888888,-0.11148148148148174,1.761481481481482
2019,146,1277,68,1181,67,N,0,1,2,1,1,-1,-1,-1,2.3422413793103445,9.926806239737274,-1.0543103448275861,5.107676518883416,1.158292282430212,1.5588259441707741,3.696305418719213,-1.0782840722495912,-3.275246305418719,-0.8720853858784903,2.695197044334976,1.1870689655172413,-1.50094417077176
2019,152,1403,61,1277,51,N,0,10,3,2,1,-1,-10,-1,2.2532051282051277,0.6469780219780148,1.7980769230769234,1.5453296703296715,1.854395604395604,2.603021978021978,1.4597069597069599,4.124084249084252,6.014194139194139,0.7032967032967026,-2.2119963369963367,1.3173076923076925,0.3850732600732627
2019,152,1438,63,1120,62,N,0,1,1,5,-4,-1,-1,4,0.3735632183908031,5.748659003831413,3.5979310344827597,8.374099616858238,2.4208429118773935,3.7213026819923343,2.455095785440614,0.24628352490421435,0.8655938697318,3.558927203065135,2.9163218390804584,0.5950957854406136,2.95816091954023
2019,154,1438,85,1403,77,N,1,8,1,3,-2,-1,-8,2,-1.171308576480989,1.2354111405835582,-0.7851458885941645,-1.4449602122015932,2.047082228116711,3.230106100795755,-0.4330238726790441,3.3346595932802785,-0.6642351900972585,3.8549955791335115,1.9076038903625108,0.8105658709106986,1.4538019451812545
2021,136,1179,53,1455,52,N,0,1,11,11,0,1,1,0,3.4215838509316754,-1.7506211180124183,-2.1822981366459615,-6.964751552795029,-3.520341614906833,-5.928260869565218,-1.0344720496894393,-0.977173913043476,-0.44223602484471947,-1.1436335403726723,0.575310559006212,-0.8798136645962731,5.3833850931677025
2021,136,1313,54,1111,53,N,0,1,16,16,0,-1,-1,0,-2.0966533466533477,-3.2160339660339687,0.48026973026972986,3.7322677322677293,-1.976023976023976,-3.3651348651348663,0.6128871128871136,-2.751248751248749,-0.3259240759240747,-1.034465534465534,1.086163836163836,0.03971028971028945,0.9805194805194803
2021,136,1411,60,1291,52,N,0,8,16,16,0,-1,-8,0,-2.8791666666666664,-4.208333333333329,2.112499999999999,3.741666666666667,-5.216666666666667,-6.783333333333333,-0.3541666666666661,-1.0416666666666643,-0.00833333333333286,-2.591666666666667,-2.770833333333334,-0.4500000000000002,-0.895833333333333
2021,136,1417,86,1277,80,N,1,6,11,11,0,-1,-6,0,-1.4924836601307199,1.4933006535947726,-0.044281045751634274,1.9413398692810482,-0.2356209150326798,-0.1982026143790847,1.015522875816993,2.00964052287582,2.4870915032679743,1.37532679738562,-0.4531045751633993,1.8776143790849678,1.7452614379084972
2021,137,1116,85,1159,68,N,0,17,3,14,-11,1,17,-11,-0.7240259740259773,4.32683982683983,-1.2683982683982684,-1.5541125541125531,0.7629870129870113,3.0227272727272734,5.287878787878787,-4.774891774891778,-2.7640692640692635,3.3528138528138527,1.0974025974025974,0.18073593073593042,1.1093073593073597
2021,137,1124,79,1216,55,N,0,24,1,16,-15,1,24,-15,6.210227272727273,12.510984848484853,0.9594696969696965,2.3291666666666657,-0.8946969696969695,0.36553030303030454,6.143560606060607,-2.736742424242429,3.418181818181818,-2.587878787878786,0.39242424242424256,1.2068181818181816,7.094696969696971
2021,137,1196,75,1439,70,N,1,5,7,10,-3,1,5,-3,1.2436507936507901,0.5404761904761912,-1.1793650793650787,-4.050793650793651,1.4285714285714306,0.41746031746031775,0.3682539682539687,-1.0682539682539698,-2.6269841269841265,3.139682539682539,2.8571428571428577,2.0134920634920634,2.517460317460317
2021,137,1222,87,1156,56,N,0,31,2,15,-13,-1,-31,13,0.4330936035741537,-0.5907159202353682,-2.0227198430859747,-5.111038465729543,-1.8541462351530988,-1.7449057426174122,-2.9795684864334753,0.46807235480004294,0.5876648142094361,2.580146017216954,-0.874686716791981,-2.2889288438487525,-1.9282445243543638
2021,137,1228,78,1180,49,N,0,29,1,16,-15,-1,-29,15,-3.190993788819874,-4.302277432712209,0.22800207039337472,1.9767080745341659,-2.915372670807452,-6.784420289855074,-1.7150621118012417,-2.758281573498966,-0.9391821946169756,-0.5750517598343698,-0.8317805383022776,-0.22800207039337472,-2.2562111801242235
2021,137,1260,71,1210,60,N,0,11,8,9,-1,-1,-11,1,2.4411764705882355,5.746323529411768,0.10695187165775444,0.5645053475935846,1.2028743315508024,1.2737299465240657,-0.19552139037433225,-1.8960561497326225,-0.040106951871656804,-2.632352941176471,2.675133689839573,1.3709893048128339,-1.1417112299465244
2021,137,1317,78,1345,69,N,1,9,13,4,9,1,9,9,-0.90625,-3.8715277777777715,0.29166666666666696,-1.2291666666666679,-1.4895833333333321,-2.6597222222222214,-2.4131944444444438,-1.5902777777777786,-1.2986111111111125,0.44444444444444287,1.552083333333334,-0.5451388888888893,1.3784722222222223
2021,137,1329,69,1251,60,N,0,9,4,13,-9,-1,-9,9,-2.78092105263158,-4.633552631578944,2.7309210526315786,7.239473684210523,-4.908552631578948,-8.133552631578947,-3.8598684210526315,-0.6407894736842081,0.5763157894736839,-5.434210526315789,-3.1486842105263158,-2.1980263157894733,-2.4309210526315788
2021,137,1331,75,1326,72,N,1,3,15,2,13,-1,-3,-13,-1.2092185592185594,-3.6499389499389494,-2.833394383394383,-5.465201465201467,1.6051892551892557,3.5996336996336993,1.4842490842490843,0.4901709401709411,1.193833943833944,-1.357264957264956,-1.688705738705739,-0.8597680097680107,-0.3075091575091573
2021,137,1333,70,1397,56,N,0,14,12,5,7,1,14,7,-0.3645833333333357,-0.8402777777777715,0.13541666666666607,-0.22569444444444287,-0.15277777777777857,-0.9583333333333321,-0.2326388888888875,-1.3055555555555536,-0.12152777777777679,-1.3194444444444429,-1.0277777777777786,-1.6284722222222223,-0.27430555555555536
2021,137,1353,60,1155,56,N,0,4,10,7,3,-1,-4,-3,-3.801190476190474,-5.23011363636364,2.3499999999999996,4.730898268398263,-0.3938041125541112,-3.644588744588745,-1.1413690476190466,-2.348566017316017,-0.5998106060606059,1.4027056277056271,-1.9952922077922075,-2.2490800865800864,-2.688257575757576
2021,137,1393,78,1361,62,N,0,16,11,6,5,-1,-16,-5,-2.755050505050505,-4.999053030303031,0.5082070707070709,-1.393623737373737,-1.8226010101010086,-0.3068181818181799,-1.5830176767676756,0.1897095959595987,-1.7771464646464654,0.8576388888888893,-0.15814393939394122,-2.002209595959596,-0.14678030303030232
2021,137,1403,65,1429,53,N,0,12,6,11,-5,1,12,-5,-0.8140092879256962,-2.258475232198151,0.27770897832817276,-1.0297213622291004,2.489938080495355,4.025232198142415,-0.9119582043343648,-3.4522832817337488,-2.4961687306501563,-2.830263157894736,0.8266253869969047,-0.30460526315789505,-1.1338235294117647
2021,137,1437,73,1457,63,N,0,10,5,12,-7,1,10,-7,0.013586956521738358,-5.731431159420282,2.6834239130434785,4.372282608695652,1.5267210144927539,-0.710144927536227,-8.84692028985507,1.428894927536227,4.124547101449277,-1.5833333333333321,-1.8505434782608692,-0.14447463768115965,4.215579710144927
2021,137,1452,84,1287,67,N,0,17,3,14,-11,-1,-17,11,-3.269841269841269,-9.464285714285715,-1.0396825396825395,-1.4444444444444429,-5.511904761904761,-6.476190476190478,-3.234126984126984,0.9365079365079367,-1.4642857142857153,4.436507936507937,-3.265873015873016,1.373015873015873,-2.4841269841269837
2021,137,1458,85,1314,62,N,0,23,9,8,1,-1,-23,-1,2.7334967320261434,3.847058823529416,-2.996078431372548,-6.449183006535943,2.4995098039215673,6.2816993464052295,6.997875816993464,2.4040849673202622,2.018137254901962,6.0808823529411775,1.3279411764705884,0.4599673202614376,0.8658496732026144
2021,138,1101,53,1400,52,N,0,1,14,3,11,1,1,11,-0.018796992481206587,-0.1795112781954913,-1.231203007518797,-3.5357142857142883,-1.2772556390977439,-1.3674812030075145,-1.2669172932330852,-4.195488721804512,4.506578947368425,-0.5620300751879697,1.656015037593984,-1.181390977443609,1.8468045112781946
2021,138,1104,68,1233,55,N,0,13,2,15,-13,1,13,-13,1.1166666666666671,7.57083333333334,2.445833333333333,8.2625,-1.3125,-0.7333333333333307,0.4083333333333332,1.37083333333333,-0.9208333333333343,-1.125,2.1416666666666657,-0.07083333333333375,-2.583333333333334
2021,138,1160,96,1207,73,N,0,23,5,12,-7,1,23,-7,0.3862179487179489,-1.7693764568764578,-1.1550116550116547,-1.838869463869461,-0.20032051282051277,-1.34222027972028,-1.36582167832168,-3.547057109557109,-0.41389860139860346,-4.244026806526808,-0.7724358974358978,-1.336247086247087,0.5419580419580425
2021,138,1166,63,1364,62,N,0,1,5,12,-7,1,1,-7,3.3874999999999993,4.6875,2.9375,7.137500000000003,-4.9375,-3.337500000000002,-0.7124999999999995,3.4750000000000014,2.0625,-0.3000000000000007,-0.33750000000000036,1.1125000000000003,-3.9625000000000004
2021,138,1199,64,1422,54,N,0,10,4,13,-9,1,10,-9,0.5,-7.186011904761898,0.5565476190476186,-4.947916666666671,3.553571428571429,4.453869047619049,-1.261904761904761,-1.8660714285714306,1.9836309523809526,3.6607142857142847,0.0,0.8809523809523814,1.8318452380952381
2021,138,1211,98,1313,55,N,0,43,1,16,-15,1,43,-15,9.046703296703296,1.5357142857142847,-0.2994505494505493,-1.3901098901098905,1.1428571428571423,0.659340659340657,-0.05494505494505475,2.6263736263736277,6.771978021978022,-0.219780219780219,1.914835164835166,-0.26098901098901095,-3.3516483516483517
2021,138,1234,86,1213,74,N,0,12,2,15,-13,-1,-12,13,-3.544642857142861,-9.375,-3.062499999999999,-5.285714285714285,-2.43452380952381,-2.6875000000000036,-2.3244047619047628,-0.821428571428573,-3.44047619047619,4.3273809523809526,-1.404761904761905,-1.5357142857142856,5.708333333333332
2021,138,1242,93,1186,84,N,0,9,3,14,-11,-1,-9,11,1.193421052631578,-0.23580827067668508,1.194830827067669,2.7350563909774444,0.36318922305764545,-1.2569548872180434,-3.304166666666667,1.8885651629072697,1.2773496240601503,-0.6212719298245606,-1.6419172932330826,-1.1215852130325814,2.742982456140351
2021,138,1261,76,1382,61,N,0,15,8,9,-1,1,15,-1,4.232638888888886,5.975694444444443,1.854166666666666,5.038194444444443,3.979166666666666,5.0,0.125,1.4930555555555571,-1.9236111111111107,-0.7291666666666679,1.2326388888888893,-1.4618055555555554,1.0451388888888893
2021,138,1268,63,1163,54,N,0,9,10,7,3,-1,-9,-3,1.6703296703296715,6.920512820512812,-1.4073260073260077,-2.3454212454212495,1.4912087912087912,1.2347985347985357,5.3531135531135545,-1.4216117216117254,-0.41868131868131897,0.26959706959706864,1.0593406593406591,1.6809523809523808,2.346520146520146
2021,138,1276,82,1411,66,N,0,16,1,16,-15,1,16,-15,-0.6791666666666671,-1.6666666666666643,2.104166666666666,2.6833333333333336,-2.9000000000000004,-5.358333333333334,-1.8374999999999995,-0.06666666666666643,2.841666666666667,-4.799999999999999,-3.0708333333333337,-0.7500000000000004,0.5874999999999995
2021,138,1325,62,1438,58,N,0,4,13,4,9,1,4,9,4.380952380952383,8.873015873015873,0.5888888888888886,2.5690476190476197,2.594444444444445,5.21904761904762,2.8007936507936515,-1.1650793650793645,4.265873015873016,1.9111111111111114,2.0317460317460316,-2.353968253968255,-1.3531746031746033
2021,138,1328,72,1281,68,N,0,4,8,9,-1,-1,-4,1,-0.9930555555555571,-2.7409722222222186,-0.9124999999999996,-1.4770833333333329,1.7513888888888882,3.885416666666668,0.06944444444444464,-0.75416666666667,-0.0076388888888878625,2.5756944444444443,-0.7249999999999996,0.249305555555555,1.6749999999999998
2021,138,1417,73,1140,62,N,0,11,11,6,5,-1,-11,-5,1.7031303749570021,3.111283109735119,1.6833505331957337,4.954936360509116,-1.7979016167870654,-2.967062263501891,-0.5963192294461646,3.7548159614723104,1.803319573443412,2.0406776745786033,-0.5377536979704161,-0.07808737530099785,-0.9560543515651876
2021,138,1425,72,1179,56,N,0,16,6,11,-5,-1,-16,5,0.6358695652173907,0.32989836250706617,-0.6180124223602483,-0.8946216826651607,-2.191770186335404,-5.033455674760024,-2.38382269904009,-1.903797289666855,-1.0669113495200442,-2.1566205533596836,1.679206662902316,-2.301242236024845,2.884034443817053
2021,139,1116,68,1403,66,N,0,2,3,6,-3,1,2,-3,3.0251336898395706,7.731461675579325,1.0647950089126557,4.885383244206775,-0.8021390374331556,-1.7919786096256693,0.4202317290552582,3.092335115864529,0.9111408199643503,3.0242424242424235,1.1016042780748663,0.6878787878787884,-1.4532976827094473
2021,139,1124,76,1458,63,N,0,13,1,9,-8,1,13,-8,4.417335115864528,7.8288770053476,-0.08244206773618501,1.7230392156862777,-1.486853832442069,0.6902852049910884,5.976158645276293,-3.392379679144387,1.0363190730837797,1.4596702317290564,1.387032085561498,-0.5804367201426031,7.9133244206773625
2021,139,1222,63,1353,60,N,0,3,2,10,-8,1,3,-8,-1.6130434782608667,-0.04940711462451475,2.2956521739130427,5.843346508563897,4.110013175230566,4.055204216073783,3.710144927536234,-1.5523056653491416,-1.2741765480895904,-0.3832674571804997,-0.4030303030303024,-0.6006587615283268,-0.2670619235836629
2021,139,1260,71,1228,58,N,0,13,8,1,7,-1,-13,-7,4.036231884057969,5.4094202898550705,-0.6154479578392618,-3.6347167325428202,3.682147562582344,6.549571805006588,1.9482872200263497,2.3638010540184418,0.712450592885375,-1.2047101449275353,-0.40415019762845805,0.07378129117259524,2.866600790513834
2021,139,1331,81,1196,78,N,0,3,15,7,8,-1,-3,-8,-1.2409645909645945,-4.50311355311355,-4.035775335775336,-9.08028083028083,0.32344322344322407,1.9289987789987784,1.7144078144078154,-1.11697191697192,0.05891330891330959,2.876862026862028,1.0097069597069597,1.4378510378510372,-1.8710012210012215
2021,139,1333,80,1329,70,N,0,10,12,4,8,-1,-10,-8,3.752083333333335,2.733333333333327,-0.6479166666666663,-1.3270833333333343,1.1041666666666679,3.008333333333333,-0.010416666666667851,3.066666666666663,-1.0229166666666671,4.0458333333333325,1.1833333333333336,1.0062499999999996,-0.15625
2021,139,1393,75,1452,72,N,0,3,11,3,8,1,3,8,0.13888888888888928,-0.8645833333333286,0.4791666666666661,3.2256944444444464,-3.840277777777777,-6.833333333333336,-3.09375,-0.10763888888888928,0.9930555555555554,-1.2604166666666679,1.2743055555555571,1.9201388888888888,-0.5451388888888893
2021,139,1437,84,1317,61,N,0,23,5,13,-8,-1,-23,8,-0.9270833333333357,-5.805555555555557,-1.4618055555555554,-6.611111111111111,-2.5138888888888893,-2.909722222222225,-0.9201388888888902,-0.17013888888888573,-1.2673611111111125,4.166666666666664,1.5451388888888893,1.3541666666666665,-0.44097222222222143
2021,140,1104,96,1268,77,N,0,19,2,10,-8,1,19,-8,1.9096153846153854,10.441346153846155,1.7016025641025632,6.384935897435895,0.9227564102564099,1.1871794871794883,3.7435897435897436,0.4182692307692264,-0.332371794871797,3.632692307692306,3.9224358974358964,0.40416666666666634,1.101282051282051
2021,140,1166,72,1325,58,N,0,14,5,13,-8,1,14,-8,-1.326785714285716,-1.9494047619047592,0.7625000000000011,2.5934523809523817,-2.0458333333333343,-0.6648809523809547,-1.7410714285714288,3.2511904761904766,-2.0505952380952372,-0.43333333333333357,0.1279761904761907,1.4636904761904765,0.8601190476190479
2021,140,1199,71,1160,53,N,0,18,4,5,-1,-1,-18,1,-2.2083333333333357,-2.2717803030303116,-0.6325757575757569,-0.06723484848484418,-0.6875,-2.932765151515156,-2.138257575757578,-0.10795454545454675,-1.06534090909091,-4.40909090909091,-2.416666666666666,-2.2064393939393945,-2.4668560606060597
2021,140,1211,87,1328,71,N,0,16,1,8,-7,1,16,-7,7.820512820512818,1.7000000000000028,-0.5423076923076922,-3.3448717948717928,3.633333333333333,5.397435897435898,-0.352564102564104,3.2858974358974358,5.24102564102564,1.356410256410257,0.8743589743589748,-0.5538461538461541,-1.03974358974359
2021,140,1276,86,1261,78,N,0,8,1,8,-7,-1,-8,7,3.2638888888888857,6.669444444444444,1.291666666666666,4.744444444444444,2.4416666666666664,3.8000000000000007,2.3,-1.3944444444444422,-2.7361111111111107,0.5333333333333314,3.8388888888888895,-0.8305555555555553,-2.5861111111111104
2021,140,1332,95,1234,80,N,0,15,7,2,5,-1,-15,-5,2.474404761904765,6.398809523809518,1.4696428571428566,3.194047619047616,2.9059523809523817,3.9208333333333343,2.1672619047619044,5.832142857142859,5.185714285714287,-1.8273809523809526,-1.836904761904762,0.5892857142857144,-1.5678571428571426
2021,140,1417,67,1101,47,N,0,20,11,14,-3,-1,-20,3,0.045235638114892396,1.587160302717578,1.117561059511523,3.161076711386311,-1.1992174062607504,-0.1622377020983805,-0.11386308909528964,-1.5214998280013745,4.112530099759205,2.444186446508427,3.295579635362916,0.2705968352253181,2.734735122119022
2021,140,1425,85,1242,51,N,0,34,6,3,3,-1,-34,-3,0.25657894736842124,2.080613465481889,1.0408834586466167,3.213644907723854,-0.22509398496240607,-2.2196684894053327,-0.783279220779221,-0.9128075871496932,0.8336893369788108,0.4273325358851672,1.710099111414901,-1.118890977443609,-2.604237867395762
2021,145,1116,72,1331,70,N,0,2,3,15,-12,1,2,-12,1.1699300699300679,4.192773892773893,-3.57004662004662,-5.293123543123542,0.788811188811188,3.3842657342657354,4.034032634032634,1.3740093240093216,1.898018648018649,2.4280885780885786,2.023776223776224,0.745571095571095,-4.150582750582751
2021,145,1124,62,1437,51,N,0,11,1,5,-4,1,11,-4,3.5852272727272734,7.358901515151516,-0.1676136363636367,-0.6875,-3.0217803030303045,-1.446969696969699,4.2935606060606055,-2.726325757575758,0.1827651515151505,1.628787878787879,2.096590909090909,1.6089015151515151,6.594696969696971
2021,145,1222,62,1393,46,N,0,16,2,11,-9,1,16,-9,-1.6074879227053138,-1.798460144927546,0.2720410628019323,0.909571256038646,0.8366545893719799,2.9855072463768124,3.165006038647345,0.04725241545893866,-2.51117149758454,-0.2854770531400952,-1.302083333333334,-0.2945350241545892,1.598278985507247
2021,145,1333,65,1260,58,N,0,7,12,8,4,-1,-7,-4,0.9895833333333357,-2.7291666666666714,0.35321969696969724,1.2547348484848442,-2.8560606060606055,-2.9109848484848495,-2.0501893939393945,2.257575757575758,1.0407196969696955,2.270833333333332,0.2537878787878789,-0.8948863636363633,-0.9005681818181817
2021,146,1211,83,1166,65,N,0,18,1,5,-4,-1,-18,4,-6.766346153846154,-2.6875,2.154807692307693,6.874038461538461,-6.3125,-6.343269230769231,-1.6432692307692296,-2.2942307692307686,-3.1201923076923066,-1.223076923076924,-1.3701923076923084,0.5413461538461539,0.7355769230769229
2021,146,1276,76,1199,58,N,0,18,1,4,-3,-1,-18,3,2.2708333333333357,2.297916666666673,1.166666666666666,2.310416666666665,0.7750000000000004,1.9770833333333364,2.5916666666666677,-2.1999999999999993,-0.90625,4.887499999999999,3.4916666666666663,0.954166666666667,-0.2354166666666666
2021,146,1417,88,1104,78,N,1,10,11,2,9,-1,-10,-9,-0.25081699346405273,6.605800653594777,3.2348856209150316,11.203839869281047,-0.40645424836601407,-0.17320261437908258,0.807189542483659,1.6221405228758172,-0.7087418300653603,3.4419934640522865,4.030228758169933,1.140114379084967,-0.09640522875817048
2021,146,1425,82,1332,68,N,0,14,6,7,-1,-1,-14,1,0.6416666666666657,0.2900432900433003,1.6761904761904756,3.60465367965368,-1.7928571428571427,-4.205194805194804,-1.9207792207792203,-3.1016233766233796,-0.09372294372294476,-0.7272727272727266,2.5241341991342,-1.5059523809523814,-0.5279220779220779
2021,147,1124,81,1116,72,N,0,9,1,3,-2,-1,-9,2,-0.5681818181818201,-0.9621212121212182,-1.0606060606060606,-2.6969696969696955,4.363636363636363,4.136363636363637,-1.9848484848484862,4.780303030303031,-0.6893939393939394,3.628787878787877,1.0454545454545459,1.6060606060606064,-9.098484848484848
2021,147,1222,67,1333,61,N,0,6,2,12,-10,1,6,-10,1.1598731884058004,3.107789855072454,1.310235507246377,5.069293478260867,-0.0036231884057968955,1.3813405797101446,2.7205615942028984,1.0923913043478244,-1.8410326086956523,-0.8722826086956523,1.5416666666666679,1.2332427536231885,0.3899456521739131
2021,148,1211,85,1425,66,N,0,19,1,6,-5,1,19,-5,8.403846153846153,4.373376623376629,1.2005494505494498,1.8014485514485514,3.3571428571428577,2.4255744255744247,-1.990009990009991,2.892607392607392,5.947302697302696,0.19580419580419672,3.590159840159841,-2.118131868131868,-2.2509990009990006
2021,148,1417,51,1276,49,N,0,2,11,1,10,-1,-2,-10,-0.7508169934640527,0.026633986928104036,0.25571895424836555,0.7163398692810468,-0.24395424836601443,-1.1398692810457511,-0.7428104575163408,2.217973856209152,1.2704248366013076,-0.716339869281045,-0.8781045751633991,1.144281045751634,3.045261437908496
2021,152,1124,78,1222,59,N,0,19,1,2,-1,1,19,-1,3.8524374176548086,6.8448616600790615,0.1679841897233203,0.5036231884057969,-3.966073781291172,-4.099143610013176,0.7292490118577071,-2.3916337285902536,1.8362977602108028,-0.18642951251646878,-0.17424242424242475,-1.3326745718050068,7.027667984189724
2021,152,1211,93,1417,90,N,1,3,1,11,-10,1,3,-10,8.2780291603821,5.2516339869281055,0.938411261940673,2.0548014077425876,3.281045751633986,4.3908999497234795,-0.462041226747111,4.037204625439923,5.203117144293614,0.9067370537958777,3.3795877325289094,0.21543489190548026,-1.6028154851684264
2021,154,1124,86,1211,70,N,0,16,1,1,0,1,16,0,-5.38111888111888,4.431818181818187,1.0559440559440558,5.71153846153846,-6.386363636363637,-6.844405594405593,4.541958041958043,-7.1101398601398635,-4.239510489510488,-1.8776223776223766,-1.1486013986013992,0.3356643356643354,9.05944055944056
2022,134,1231,66,1461,58,N,0,8,12,12,0,1,8,0,1.7887820512820483,2.1669871794871796,-1.4733974358974358,-4.968589743589739,0.13493589743589673,0.6637820512820483,0.8157051282051277,-0.12307692307692264,4.185256410256409,0.5576923076923066,1.479807692307693,2.7717948717948717,2.335576923076921
2022,134,1411,76,1394,67,N,0,9,16,16,0,-1,-9,0,0.5202684742158432,2.624933545986181,0.42816321105794763,1.145933014354064,4.129452418926103,3.517676767676768,0.5091706539074963,-2.2099282296650706,3.0441919191919187,-0.3024986709197215,2.802033492822968,-3.116095162147794,3.3161881977671435
2022,135,1323,89,1353,87,N,2,2,11,11,0,1,2,0,-0.3644078144078158,-1.8669108669108638,2.484798534798534,5.320024420024421,0.9533577533577535,0.05360195360195341,-2.9289377289377283,1.5781440781440779,-1.563064713064712,-1.062087912087911,-2.1559218559218554,-1.9545787545787547,-2.4351037851037862
2022,135,1460,93,1136,82,N,0,11,16,16,0,-1,-11,0,-0.9123015873015881,3.76843711843712,2.1181929181929195,8.925213675213673,-0.13601953601953554,0.7717948717948744,1.5460012210012213,2.936324786324789,-0.2734737484737497,1.2858974358974358,0.2707264957264952,1.0898656898656895,2.521062271062272
2022,136,1116,75,1436,71,N,0,4,4,13,-9,1,4,-9,0.5637962962962959,5.147222222222226,-1.490555555555555,-2.776851851851852,6.758240740740742,8.597870370370373,4.085555555555555,-0.9752777777777801,-0.2932407407407407,3.4238888888888894,2.3503703703703707,1.4648148148148152,3.3221296296296305
2022,136,1124,85,1313,49,N,0,36,1,16,-15,1,36,-15,2.2829670329670293,3.5402930402930366,1.4166666666666679,2.745421245421248,-1.8800366300366296,-3.0998168498168504,2.20970695970696,-4.276556776556777,2.844322344322343,-1.354395604395604,2.6831501831501825,0.16941391941391926,-0.7518315018315
2022,136,1166,72,1361,69,N,1,3,9,8,1,1,3,1,2.1314229249011873,1.5837450592885318,0.7087450592885371,5.187252964426879,0.2544466403162051,-1.1610671936758887,-0.2717391304347814,3.6687252964426875,1.6657608695652186,1.362154150197627,-2.1356225296442686,0.08448616600790526,-4.517292490118578
2022,136,1211,93,1209,72,N,0,21,1,16,-15,-1,-21,15,-7.244871794871798,-1.356410256410257,-0.37179487179487225,1.7217948717948701,1.1282051282051277,1.1666666666666679,2.462820512820512,-7.726923076923079,-4.235897435897439,-1.6371794871794876,1.7205128205128215,-1.7602564102564102,0.5512820512820511
2022,136,1242,83,1411,56,N,0,27,1,16,-15,1,27,-15,2.3293650793650826,0.6746031746031775,1.3888888888888893,2.2678571428571423,0.7123015873015888,-0.16468253968254132,-1.476190476190478,-1.8690476190476204,3.9007936507936503,-2.944444444444443,0.48214285714285765,-1.3194444444444446,-1.172619047619051
2022,136,1272,64,1129,53,N,0,11,9,8,1,-1,-11,-1,-2.6397435897435884,-0.9926739926739998,1.1126373626373622,5.0287545787545795,-2.7446886446886456,-3.5536630036630044,-1.8430402930402927,-1.3818681318681314,-5.070512820512819,-5.582417582417584,-3.044139194139193,-2.107326007326007,-3.0879120879120876
2022,136,1276,75,1161,63,N,0,12,11,6,5,-1,-12,-5,-2.3514005602240893,-3.8327731092436963,0.7025210084033624,2.586484593837536,0.3927871148459374,0.44530812324930125,-2.503921568627451,-2.6227591036414566,-1.387710084033614,-0.9234943977591055,1.6916666666666664,-0.16078431372549007,1.3369747899159652
2022,136,1293,92,1362,87,N,1,5,7,10,-3,1,5,-3,-1.841384863123995,-3.0551529790660226,-2.7560386473429954,-6.470209339774559,1.1465378421900176,3.565217391304344,-0.000402576489532791,-1.1247987117552363,0.697665056360707,0.9033816425120769,0.36996779388083745,-2.1489533011272144,-3.985104669887278
2022,136,1308,70,1163,63,N,0,7,12,5,7,-1,-7,-7,1.7101449275362341,6.037439613526573,-0.30193236714975846,-2.137681159420289,-0.9710144927536213,-2.9239130434782616,2.274154589371978,0.47463768115942173,-0.24275362318840443,-1.5603864734299506,1.6050724637681153,2.3429951690821262,0.09178743961352609
2022,136,1314,95,1266,63,N,0,32,8,9,-1,-1,-32,1,-0.07602339181286766,-1.6882309941520504,0.5522660818713456,1.3453947368421026,-1.8563596491228065,-1.8786549707602376,-3.184941520467836,-1.2456140350877192,1.5453216374269,0.5095029239766085,2.539839181286549,1.2266081871345031,2.5266812865497066
2022,136,1344,66,1355,57,N,0,9,4,13,-9,1,9,-9,-6.609999999999999,-4.7450000000000045,-1.104285714285715,1.6835714285714332,0.1678571428571427,0.6078571428571422,2.387142857142857,-2.4628571428571426,-0.9900000000000002,-0.03142857142857203,-0.6850000000000005,1.2285714285714286,0.1999999999999993
2022,136,1350,67,1234,63,N,0,4,12,5,7,-1,-4,-7,3.188498699368264,6.453827573392786,0.4550353028613916,0.4493218134522472,1.7950111482720175,2.0932274247491662,3.477006688963211,-0.7009011519881057,1.0483091787439598,-0.40756224451876655,-0.7186454849498327,1.9711073950204385,3.2738758825715344
2022,136,1388,82,1231,53,N,0,29,5,12,-7,-1,-29,7,1.122115384615384,1.1907967032967122,-0.3900641025641036,-1.5965659340659322,3.3670787545787544,6.181639194139194,0.5597527472527473,2.070375457875457,2.911446886446887,0.3642399267399252,-0.561858974358973,2.247985347985348,1.6004578754578738
2022,136,1389,85,1246,79,N,1,6,15,2,13,-1,-6,-13,5.537462537462538,8.258519258519257,0.0329392829392825,1.2895437895437887,-2.124958374958375,-4.1384726384726385,2.4032356532356527,0.048201798201798596,2.5902430902430886,-2.5594960594960607,-0.7147574647574642,-0.5538073038073037,-4.708763458763457
2022,136,1397,88,1255,56,N,0,32,3,14,-11,-1,-32,11,0.023393273393274683,-2.1499333999334027,-0.10439560439560402,-3.3871128871128846,2.3420745920745922,3.176656676656677,-0.36322011322011427,-1.6734931734931742,-0.9771894771894765,-0.5711788211788225,-1.1173826173826171,-2.3999333999333996,-0.8832833832833842
2022,136,1417,57,1103,53,N,0,4,4,13,-9,-1,-4,9,-4.4404184704184715,-12.283362193362194,1.2430880230880224,2.873722943722946,-0.5194227994228005,1.0442568542568544,-2.6595959595959577,-0.42603174603174665,-1.9617316017316035,2.007936507936506,-1.7433477633477636,0.14532467532467575,-0.8545598845598832
2022,137,1112,87,1460,70,N,0,17,1,16,-15,1,17,-15,0.255645161290321,2.279445822994205,1.1962779156327557,3.48614557485525,-0.07022332506203455,0.9384615384615387,1.5570099255583134,4.370016542597188,3.6433209263854405,1.791273779983456,-0.20597601323407755,1.954177005789909,2.67390405293631
2022,137,1120,80,1240,61,N,0,19,2,15,-13,1,19,-13,2.2906432748537995,10.057407407407403,-0.3363547758284593,2.979044834307995,3.9302144249512665,4.054483430799216,3.0205653021442505,-0.2104288499025344,0.1374269005847939,-0.3229044834307988,2.5863547758284593,3.8585769980506823,4.510721247563353
2022,137,1181,78,1168,61,N,0,17,2,15,-13,-1,-17,13,-4.246992481203009,-4.451942355889727,-2.015852130325815,-4.38533834586466,1.625125313283208,1.7231829573934832,-0.47355889724310707,-4.066729323308273,-5.137280701754385,0.8704887218045094,1.428007518796992,-3.7189223057644107,1.870676691729324
2022,137,1222,82,1412,68,N,0,14,5,12,-7,1,14,-7,-0.1357635467980316,-2.838423645320198,1.354285714285714,3.2816748768472905,-3.000197044334975,-2.0213793103448268,1.4588177339901467,0.006305418719207978,3.671822660098524,1.1977339901477837,-0.5309359605911332,1.060788177339901,0.6626600985221671
2022,137,1228,54,1151,53,N,0,1,4,13,-9,-1,-1,9,0.14658008658008725,-1.9066378066378036,-1.6046897546897565,-2.528874458874462,-0.7197402597402611,-2.3465512265512274,-1.353015873015874,-2.1188744588744584,-3.520129870129871,-0.031341991341991005,1.4481673881673878,-0.7172582972582973,-0.8479076479076468
2022,137,1235,59,1261,54,N,0,5,11,6,5,1,5,5,-1.2560606060606077,-3.252272727272725,-0.07348484848484826,0.17954545454545467,-4.077272727272726,-4.43409090909091,-2.8272727272727263,-1.5825757575757606,1.918939393939393,-0.6212121212121211,-2.3446969696969706,-0.8984848484848484,-1.9901515151515135
2022,137,1274,68,1425,66,N,0,2,10,7,3,1,2,3,1.3662924032489236,-0.9045389393215544,0.18361204013377996,0.7594362159579546,-0.2066172957477299,-1.992140468227424,-3.262111801242238,-4.518227424749167,-0.04125656951743828,-2.0910893454371724,4.305924510272337,-1.3880793119923558,-1.1372431915910184
2022,137,1277,74,1172,73,N,0,1,7,10,-3,-1,-1,3,-1.1013986013986,-2.718822843822842,1.1625874125874134,3.2890442890442877,1.9012237762237767,2.0288461538461533,-2.4050116550116547,-0.4341491841491809,-2.893648018648019,-3.2502913752913756,-0.8103146853146859,-2.222610722610723,-0.9536713286713301
2022,137,1323,78,1104,64,N,0,14,11,6,5,-1,-14,-5,2.3609215346057475,6.885916714864088,0.7513688066319659,6.731145170618852,3.6264893001735103,5.7123674571043,5.658020050125313,-0.22074416811258857,1.233217659533448,4.324908424908424,1.9664256795835735,2.82907268170426,5.394842876421825
2022,137,1326,54,1260,41,N,0,13,7,10,-3,-1,-13,3,0.05997949419002069,-0.11609990886307031,1.0167891319207119,2.491555593529281,-1.3741313511050333,-1.1780160628844847,-1.0654904306220097,-0.36353668261563143,1.9882946001367063,1.669201412622467,2.2037622465254048,-2.5675410116199586,2.4651116427432207
2022,137,1345,78,1463,56,N,0,22,3,14,-11,1,22,-11,1.595839345839348,-1.8222703222703203,0.7172919672919669,-0.4272486772486772,-0.20815295815295798,1.177489177489175,2.136243386243388,-0.22510822510822592,3.1173641173641187,-0.8124098124098111,-1.7165704665704666,-0.2474747474747474,-2.9339826839826824
2022,137,1395,69,1371,42,N,0,27,9,8,1,-1,-27,-1,-0.14166666666666572,3.6583333333333385,1.5499999999999998,3.025000000000002,2.633333333333333,1.3249999999999993,-0.10000000000000142,0.9583333333333321,-3.958333333333334,-2.1083333333333325,0.916666666666667,1.083333333333333,0.3999999999999986
2022,137,1400,81,1439,73,N,0,8,6,11,-5,1,8,-5,-1.4825663466967818,0.0852860907208779,-2.2884904950122333,-2.7398127235083756,3.621000376435159,4.880034820252213,1.7032279314888,-0.48150762281197146,-1.6050724637681153,0.5906973461321297,2.170289855072464,0.2548230754752492,3.0184688499905903
2022,137,1403,97,1286,62,N,0,35,3,14,-11,-1,-35,11,1.4142857142857146,1.6085714285714232,1.725714285714286,1.4638095238095232,3.7942857142857136,3.233015873015873,-0.8780952380952378,-0.08444444444444343,0.3295238095238098,-0.4228571428571435,-2.6571428571428575,0.12380952380952426,3.2514285714285727
2022,137,1437,80,1174,60,N,0,20,2,15,-13,-1,-20,13,2.041208791208792,-1.9038461538461604,-1.800824175824176,-5.456959706959708,1.1341575091575073,2.6781135531135547,-0.937728937728938,-0.2124542124542117,0.9555860805860803,3.278388278388279,0.19276556776556752,1.5728021978021975,0.9313186813186789
2022,137,1458,67,1159,60,N,0,7,3,14,-11,-1,-7,11,2.5689935064935057,-1.2616341991341926,3.2405303030303028,2.083603896103895,-2.929653679653679,-3.1347402597402603,0.02002164502164483,2.2800324675324646,5.649621212121215,2.832521645021645,0.5698051948051948,0.946158008658009,-2.563582251082252
2022,138,1116,53,1308,48,N,0,5,4,12,-8,1,5,-8,1.7225724637681168,5.437318840579714,-0.9074637681159423,-1.7105072463768138,3.1798188405797134,2.3369202898550725,-0.1562318840579735,0.23800724637681014,0.5177898550724649,0.4625362318840587,3.106811594202899,-0.021014492753622882,0.9809057971014497
2022,138,1211,82,1272,78,N,0,4,1,9,-8,1,4,-8,4.721062271062273,5.7087912087912045,1.5146520146520146,3.6972527472527474,-2.597252747252748,-4.2404761904761905,-2.5866300366300354,5.529304029304029,0.5192307692307718,-3.0366300366300365,-1.9324175824175818,0.4412087912087914,-2.6703296703296715
2022,138,1242,79,1166,72,N,0,7,1,9,-8,-1,-7,8,-2.376082251082252,-2.0054112554112606,-0.5946969696969706,1.913961038961041,-2.9572510822510836,-4.5676406926406905,-1.4404761904761898,3.8122294372294405,-1.970238095238095,2.2878787878787854,-0.7889610389610393,0.8181818181818183,-3.433441558441558
2022,138,1276,76,1397,68,N,0,8,11,3,8,1,8,8,2.926308985132515,-1.641402714932127,-1.656916612798966,-6.606173238526178,-0.057530704589527915,-1.563348416289596,-1.4305106658047837,-0.04088558500323103,0.24499030381383236,-1.3427601809954748,-3.6401098901098905,-1.0300581771170005,-2.305106658047835
2022,138,1314,93,1124,86,N,1,7,8,1,7,-1,-7,-7,-0.5662393162393187,-0.6372863247863307,-0.006944444444443754,0.3733974358974379,-1.5496794871794872,-0.5085470085470121,1.713675213675213,-4.6634615384615365,0.47329059829059617,0.26068376068376153,3.3627136752136746,-0.5309829059829059,1.1063034188034173
2022,138,1344,79,1350,51,N,0,28,4,12,-8,1,28,-8,-2.124492753623187,-1.4460869565217394,-1.187101449275362,-1.9805072463768099,2.4706521739130434,3.4396376811594216,2.8723913043478255,-0.5935507246376801,-2.413913043478262,1.322608695652173,-2.8299275362318843,0.9847826086956522,2.3884057971014485
2022,138,1389,70,1293,60,N,0,10,15,7,8,-1,-10,-8,1.5159932659932664,3.0084175084175087,0.46212121212121193,3.6254208754208754,-1.2163299663299654,-0.07070707070707272,0.6203703703703702,-0.584175084175083,0.4410774410774394,-0.545454545454545,0.3190235690235692,-2.076599326599326,-6.138047138047135
2022,138,1417,72,1388,56,N,0,16,4,5,-1,-1,-16,1,-2.603928571428572,-8.902500000000003,0.40154761904761926,0.40321428571428797,-4.074166666666667,-6.3605952380952395,-3.548214285714285,-0.605595238095237,-0.8659523809523826,2.479166666666666,-0.8222619047619055,-0.3573809523809519,-1.3688095238095244
2022,139,1112,85,1395,80,N,1,5,1,9,-8,1,5,-8,2.1889784946236546,4.418548387096777,1.8693548387096781,4.680376344086021,2.653494623655913,2.1750000000000007,-0.18145161290322598,3.3975806451612875,3.60806451612903,0.46370967741935587,-0.5239247311827953,0.6432795698924734,1.6623655913978475
2022,139,1181,85,1277,76,N,0,9,2,7,-5,1,9,-5,2.769480519480524,2.7175324675324717,0.40205627705627833,1.9264069264069263,0.771645021645023,0.9702380952380949,0.3019480519480524,1.4399350649350673,0.6287878787878771,-1.8322510822510818,-0.2759740259740262,0.8149350649350646,-2.4399350649350655
2022,139,1222,68,1228,53,N,0,15,5,4,1,1,15,1,1.3565308254963426,-1.173632880529432,-1.2904040404040416,-2.587199582027168,-1.9799373040752357,-1.2393591083246278,1.3486590038314166,-1.7268547544409643,0.7916927899686534,0.8549634273772213,2.8458028561476825,2.16924416579589,1.4604667363288044
2022,139,1235,54,1458,49,N,0,5,11,3,8,1,5,8,-0.5279761904761919,-3.718452380952378,-0.03750000000000053,-1.3732142857142833,-3.052380952380952,-3.1142857142857157,-0.034523809523809845,-2.1434523809523824,3.5458333333333343,4.961309523809522,2.9523809523809517,0.4113095238095239,0.35535714285714093
2022,139,1274,79,1120,61,N,0,18,10,2,8,-1,-18,-8,-0.19516908212560224,7.694363929146533,1.0012882447665046,5.477214170692434,3.4885668276972623,5.117069243156196,4.90523349436393,4.459822866344609,-0.5932367149758448,3.259017713365539,-0.15346215780998484,4.114412238325282,4.297906602254429
2022,139,1345,81,1400,71,N,0,10,3,6,-3,1,10,-3,2.9793169793169803,1.053631553631547,1.3164983164983166,1.2491582491582491,0.2784992784992788,2.284992784992781,0.46200096200096397,3.3564213564213574,2.24867724867725,0.9595959595959584,-3.208994708994709,-0.36291486291486263,-2.8275613275613285
2022,139,1403,59,1323,53,N,0,6,3,11,-8,-1,-6,8,0.029523809523809064,0.8442857142857108,2.8376190476190466,4.685238095238095,-1.0314285714285703,-3.1446031746031764,-2.5204761904761908,1.0107936507936515,0.6476190476190489,-3.589523809523808,-2.7785714285714276,-1.4371428571428568,-3.3147619047619035
2022,139,1437,71,1326,61,N,0,10,2,7,-5,-1,-10,5,1.8026578684473442,-2.2192938640307105,-1.2908275934591735,-4.8681581576318464,0.6184079078815898,1.549581996950419,-0.583548030916452,1.9457253273042738,0.8482438614017553,1.5199011514800986,-1.8711157263788847,2.863557495136442,1.5793022766706954
2022,143,1116,74,1211,68,N,0,6,4,1,3,1,6,3,-5.177371794871796,-2.1814102564102527,-0.9567948717948722,0.730128205128203,5.112371794871798,5.427500000000002,1.1428205128205118,-5.241089743589747,-2.5883974358974378,0.214487179487179,0.9671794871794877,-2.0435897435897434,1.6771153846153872
2022,143,1181,78,1403,73,N,0,5,2,3,-1,1,5,-1,3.44857142857143,4.624047619047616,1.7269047619047626,2.070952380952381,0.19119047619047613,-1.0303174603174625,0.17952380952380942,2.219126984126987,3.3249999999999993,-2.6478571428571414,-2.496428571428571,2.381904761904762,-2.188571428571427
2022,143,1222,72,1112,60,N,0,12,5,1,4,-1,-12,-4,-0.26073414905450676,2.584352984797924,-0.5806451612903221,-0.18772710418984317,3.579644048943269,2.9413793103448285,-0.5995550611790872,4.185799035965889,1.322432332220984,1.968594734890619,-2.751798294401185,-0.2529847979236184,-1.0031516499814614
2022,143,1437,63,1276,55,N,0,8,2,11,-9,-1,-8,9,3.3164188752424053,0.9574983839689679,-2.9426308985132525,-7.8946347769877185,-0.45862960568842936,0.35423400129282356,0.2590497737556561,1.959114414996769,2.665319974143504,1.8715255332902405,-1.4560439560439562,1.0990627020038781,0.5657724628312852
2022,144,1242,66,1344,61,N,0,5,1,4,-3,1,5,-3,4.008809523809525,1.739047619047625,0.0983333333333345,-2.11214285714286,-1.4654761904761902,-1.9769047619047626,-0.33952380952380956,0.3259523809523799,2.460238095238095,0.6266666666666687,0.9171428571428581,0.20000000000000018,0.2107142857142854
2022,144,1274,70,1235,56,N,0,14,10,11,-1,-1,-14,1,-3.0007246376811594,-1.5380434782608674,-0.6329710144927541,0.3336956521739154,-1.6021739130434778,-0.859782608695653,1.447826086956523,0.19963768115942315,0.5873188405797105,4.1442028985507235,-0.569202898550726,0.21811594202898554,2.702536231884057
2022,144,1314,73,1417,66,N,0,7,8,4,4,1,7,4,-0.5136507936507932,-3.614801587301585,1.845992063492063,3.9210714285714303,-0.300357142857143,-1.377460317460315,-1.56111111111111,2.754523809523807,0.8324603174603169,2.8968253968253954,-1.8500396825396823,0.7299206349206351,-2.1733730158730147
2022,144,1389,67,1345,64,N,0,3,15,3,12,-1,-3,-12,3.6059403559403584,1.538840788840787,2.075877825877826,4.966690716690717,-0.36976911976911886,-0.4437229437229462,0.49735449735449855,0.9819624819624835,2.847162097162098,-1.3073593073593077,-3.214045214045214,-1.724747474747474,-4.731962481962478
2022,145,1181,78,1116,69,N,0,9,2,4,-2,-1,-9,2,-2.561071428571431,1.0809523809523824,-0.7219047619047627,0.8107142857142833,3.9663095238095263,5.082261904761907,0.9038095238095227,-1.8010714285714329,-2.110833333333332,2.3028571428571425,2.1764285714285716,-1.6452380952380947,3.2210714285714293
2022,145,1437,50,1222,44,N,0,6,2,5,-3,-1,-6,3,3.7397309586964766,1.8005873436907862,-1.1401098901098905,-3.323380068207655,-2.2586585827965138,0.3498294808639635,2.8315649867373995,1.031470253884045,4.409075407351271,3.005646078059872,2.180162940507767,3.092876089427813,3.4682644941265615
2022,146,1242,76,1274,50,N,0,26,1,10,-9,1,26,-9,0.1314182194617004,1.1060041407867516,-0.032971014492753525,-0.3734472049689437,1.682349896480332,3.0283126293995846,3.2383022774327124,2.44725672877847,0.615890269151139,1.9775362318840592,-3.0037267080745345,0.6847826086956523,1.6715838509316754
2022,146,1314,69,1389,49,N,0,20,8,15,-7,1,20,-7,3.6641414141414153,6.55239898989899,2.2468434343434343,6.9564393939393945,-0.17234848484848442,-2.6262626262626227,0.08333333333333393,2.337121212121211,1.862373737373737,-1.7121212121212128,-2.136994949494949,-1.016414141414141,-4.788510101010097
2022,152,1242,81,1437,65,N,0,16,1,2,-1,1,16,-1,3.547161172161175,1.6437728937728906,-2.1817765567765566,-6.248626373626376,0.6103479853479854,2.654304029304029,0.9789377289377281,1.2339743589743577,2.8603479853479854,1.9688644688644708,-0.34890109890109855,1.5549450549450547,1.9134615384615365
2022,152,1314,81,1181,77,N,0,4,8,2,6,-1,-4,-6,1.650793650793652,-1.6240079365079367,-0.45337301587301493,-2.3482142857142847,-0.7113095238095237,-0.26587301587301937,-0.412698412698413,-0.4880952380952337,2.194444444444443,-0.8789682539682531,0.10218253968253954,1.9424603174603172,-0.546626984126986
2022,154,1242,72,1314,69,N,0,3,1,8,-7,1,3,-7,0.37103174603174693,-2.7490079365079367,-0.8819444444444438,-3.0446428571428577,-0.1279761904761898,1.251984126984123,0.3015873015873005,-3.2857142857142847,0.4563492063492056,-0.44444444444444287,0.6557539682539684,-0.15277777777777768,1.7926587301587276
2023,134,1338,60,1280,59,N,0,1,11,11,0,-1,-1,0,-2.186688311688311,-0.5248917748917776,-3.533008658008658,-5.252164502164501,-1.8777056277056285,0.326298701298704,3.2267316017316006,-0.461580086580085,0.10551948051948123,1.2386363636363633,3.2429653679653683,-0.4848484848484853,-1.5817099567099575
2023,134,1394,75,1369,71,N,0,4,16,16,0,-1,-4,0,-0.04603328173374521,-0.527844427244581,0.44678792569659453,2.390208978328168,0.8658862229102162,3.3557856037151694,-2.2973490712074307,1.7811339009287934,-1.1192337461300301,-0.0359713622291018,-1.509326625386997,1.7070046439628483,1.8475812693498455
2023,135,1113,98,1305,73,N,0,25,11,11,0,1,25,0,0.836796536796534,6.1312770562770496,0.4086580086580085,3.474134199134202,-4.09448051948052,-2.889935064935063,3.298809523809525,-0.6196969696969674,-0.024458874458876068,1.4316017316017309,1.3914502164502158,1.5822510822510827,0.13149350649350566
2023,135,1192,84,1411,61,N,0,23,16,16,0,1,23,0,2.7578431372549055,2.9872549019607817,2.875490196078431,6.21078431372549,-1.1852941176470573,-3.907843137254904,0.25833333333333286,-3.158823529411766,2.7823529411764696,-2.92549019607843,0.7617647058823529,-1.2872549019607842,0.3039215686274517
2023,136,1104,96,1394,75,N,0,21,1,16,-15,1,21,-15,-0.4109800362976408,-0.7461887477313951,1.2969147005444652,5.8670598911070755,0.4661524500907426,1.984119782214158,0.910980036297639,5.982667876588025,-1.7018148820326662,2.8336660617059906,-2.734301270417422,3.072141560798548,-0.07286751361161237
2023,136,1116,73,1228,63,N,0,10,8,9,-1,1,10,-1,0.2660256410256423,-1.9493589743589723,-2.392948717948718,-8.30576923076923,1.9807692307692317,2.72179487179487,-1.3974358974358978,-0.9429487179487168,0.9121794871794897,0.23397435897435948,1.4346153846153848,-0.19102564102564124,2.6596153846153854
2023,136,1120,83,1234,75,N,0,8,9,8,1,1,8,1,-2.704183535762482,-4.383434547908223,-1.2004048582995956,-2.641801619433199,0.0776315789473685,0.9245951417004044,-0.6625843454790825,-0.3094804318488542,-2.3836032388663995,2.3850877192982445,1.2265182186234815,1.4415991902834002,4.842678812415656
2023,136,1181,74,1331,51,N,0,23,5,12,-7,1,23,-7,-2.39903846153846,-5.90384615384616,-4.298076923076922,-10.302884615384613,1.9230769230769234,2.3701923076923066,2.855769230769231,-0.3509615384615401,0.5240384615384617,2.4951923076923066,-0.0288461538461533,-1.0576923076923075,-0.44711538461538325
2023,136,1202,68,1438,67,N,0,1,13,4,9,1,1,9,4.243809523809524,4.4177380952381,3.086666666666667,8.917380952380952,1.3499999999999996,1.7436904761904763,1.1846428571428582,0.9553571428571388,0.8901190476190468,2.819285714285714,0.05642857142857238,-0.6179761904761905,2.807380952380953
2023,136,1222,63,1297,52,N,0,11,1,16,-15,1,11,-15,0.9228494623655905,3.342473118279571,-1.2255376344086022,-2.282258064516128,2.3244623655913976,4.74462365591398,3.3524193548387107,4.450268817204304,-0.6397849462365581,-1.3663978494623663,-1.4913978494623645,2.5298387096774193,2.705645161290322
2023,136,1242,96,1224,68,N,0,28,1,16,-15,-1,-28,15,0.3748259537733212,0.24101921470342802,0.9157616262879422,-0.15904344193818076,0.7996727930938476,1.228139793929266,1.7969228627123357,-2.0962823725981607,-1.205304928989138,2.476573377889167,-1.1321010860484542,-0.4831175160122534,0.8427318295739354
2023,136,1268,67,1452,65,N,0,2,8,9,-1,1,2,-1,-1.7675438596491233,-1.9833959899749374,-0.3963032581453625,0.27067669172932085,-3.578007518796994,-4.938283208020049,-1.3308270676691745,0.8577694235588993,-1.7380952380952372,-2.170112781954888,-1.303571428571428,0.56234335839599,-2.308897243107765
2023,136,1281,76,1429,65,N,0,11,7,10,-3,1,11,-3,0.781388888888884,3.072222222222223,-0.2644444444444449,1.3052777777777784,-1.2569444444444446,-1.5516666666666623,0.34527777777777846,-5.277777777777779,-1.431111111111111,-0.24583333333333357,4.97638888888889,-0.7633333333333332,1.359444444444442
2023,136,1321,75,1129,67,N,0,8,7,10,-3,-1,-8,3,1.7728527511136214,-1.6354225484660248,-0.48560135516657255,-3.095394943221031,0.12431771127423197,0.41756070016939617,-1.799799234581842,2.7045297697471575,-2.0362005144613846,1.8333960725265062,-2.5862036514210427,-1.2402597402597406,0.6804692891649395
2023,136,1336,76,1401,59,N,0,17,10,7,3,1,17,3,2.267163947163951,0.6367055167055184,4.136394716394715,8.054405594405594,-10.154506604506604,-13.071149961149963,-5.837288267288268,2.345843045843047,1.3386091686091692,-3.54959595959596,-2.5489898989899,0.033317793317793054,-3.4112276612276595
2023,136,1343,59,1112,55,N,0,4,15,2,13,-1,-4,-13,0.9729010025062621,1.8402255639097689,0.15585839598997353,0.11419172932330568,2.435463659147869,3.0281954887218028,0.9218358395989963,-0.28211152882205326,4.069862155388474,1.5292919799498748,1.3414786967418557,0.020050125313282763,0.9277882205513777
2023,136,1361,63,1158,57,N,0,6,5,12,-7,-1,-6,7,3.7884615384615365,7.7051282051282115,2.1961538461538463,8.410256410256409,0.3935897435897431,0.3141025641025621,3.962820512820512,1.4807692307692264,0.9461538461538463,0.27051282051282044,-0.11282051282051242,-0.7717948717948713,1.1820512820512796
2023,136,1397,58,1418,55,N,0,3,4,13,-9,1,3,-9,-1.7077639751552773,-0.24937888198758174,1.4062111801242239,4.875155279503105,-1.2409937888198748,-2.919565217391302,1.1829192546583869,0.8341614906832291,2.628571428571428,-0.6152173913043466,0.547204968944099,0.5149068322981365,-0.43695652173913047
2023,136,1400,81,1159,61,N,0,20,2,15,-13,-1,-20,13,1.0757692307692288,-2.8955769230769164,0.18769230769230738,-2.3482692307692297,-3.3655769230769224,-2.6984615384615402,-1.6375000000000002,1.894807692307694,1.4309615384615366,-0.4976923076923079,-0.5775000000000006,-0.9048076923076924,-5.988846153846154
2023,136,1417,86,1421,53,N,0,33,2,15,-13,1,33,-13,1.6932019704433472,7.361576354679798,-1.5079802955665027,-2.4813793103448276,-1.7052216748768476,-3.5293596059113312,3.5175369458128074,-0.5410837438423641,1.1636453201970447,-3.1646305418719205,1.1818719211822657,-0.43724137931034424,0.10177339901477822
2023,137,1124,74,1364,56,N,0,18,3,14,-11,1,18,-11,0.6946753246753268,4.589220779220781,4.905194805194806,10.037922077922076,1.756753246753247,2.243766233766234,2.5649350649350655,-1.3001298701298687,1.0672727272727283,1.9702597402597402,0.7988311688311693,-0.08181818181818157,1.3633766233766238
2023,137,1163,87,1233,63,N,0,24,4,13,-9,1,24,-9,-0.7249603174603152,-1.135052910052913,1.8241931216931224,5.594100529100526,0.9209391534391536,0.7015873015873026,2.1350661375661364,1.6574074074074048,2.528412698412698,2.121534391534393,-1.4037962962962958,-1.100582010582011,1.5085052910052923
2023,137,1166,72,1301,63,N,0,9,6,11,-5,1,9,-5,-0.689026915113871,-4.631107660455484,0.5006211180124236,0.4775362318840557,1.5042960662525893,1.0459627329192571,-2.57148033126294,3.05351966873706,3.189596273291926,1.7702898550724626,-2.2043995859213252,-0.0922360248447216,-4.477225672877847
2023,137,1192,63,1345,58,N,0,5,16,1,15,1,5,15,3.773360378634216,7.307369844489514,1.7220419202163617,2.305611899932387,-2.6732251521298167,-4.296348884381338,-1.0678160919540218,-3.338133874239354,-0.7463826910074367,0.03887762001352435,2.6979716024340776,-1.9131169709263016,4.879783637592968
2023,137,1194,66,1272,65,N,0,1,9,8,1,1,1,1,-0.7203801945181247,0.8637820512820511,3.257128647214854,8.721153846153847,-7.103282493368701,-8.31360521662246,-0.6241158267020346,-0.03381962864721544,-0.7975795755968171,-2.7900088417329805,-3.1103006189213085,-2.2217064544650746,-3.9175508399646333
2023,137,1211,82,1213,70,N,0,12,3,14,-11,1,12,-11,5.133573833573834,4.704713804713805,-0.6691678691678682,-2.5381914381914363,-0.4055796055796037,0.010966810966809959,-0.25305435305435253,0.3419913419913456,2.91943241943242,-0.09586339586339498,2.358393458393458,0.1076479076479071,-0.91245791245791
2023,137,1231,71,1245,60,N,0,11,4,13,-9,1,11,-9,1.8805361305361288,-2.2855477855477844,-1.8741258741258742,-7.333333333333336,0.19289044289044455,0.2750582750582744,-0.7336829836829839,3.6754079254079244,3.873543123543124,0.7301864801864806,-2.910256410256409,1.1526806526806528,-2.6754079254079244
2023,137,1243,77,1286,65,N,0,12,3,14,-11,1,12,-11,2.2850241545893724,4.944444444444443,1.729468599033817,3.2342995169082123,-0.8574879227053138,-1.4057971014492736,2.10144927536232,1.7705314009661848,3.954106280193235,2.3792270531400987,1.3647342995169076,-0.5676328502415457,-0.7294685990338152
2023,137,1246,61,1344,53,N,0,8,6,11,-5,1,8,-5,0.17316017316017351,0.6103896103896105,-0.4740259740259738,-0.9718614718614731,-2.8095238095238084,-2.2142857142857117,1.3051948051948052,0.15800865800865793,0.4978354978354993,0.18181818181818343,-0.05194805194805152,-0.5324675324675328,1.4870129870129887
2023,137,1266,78,1436,61,N,0,17,2,15,-13,1,17,-13,4.0240259740259745,5.955519480519484,0.32326839826840015,1.6160173160173166,0.38409090909090793,-0.1569264069264058,2.1297619047619047,-2.4661255411255425,3.016017316017315,1.0905844155844147,3.839935064935065,0.1401515151515147,1.8775974025974023
2023,137,1274,63,1179,56,N,0,7,5,12,-7,-1,-7,7,-3.329120879120879,-2.0983516483516453,-0.5303296703296709,-0.25296703296703527,-1.3793406593406594,-1.5661538461538473,-1.1524175824175815,2.4326373626373616,-1.6413186813186815,-0.10659340659340621,-1.4013186813186813,-1.0273626373626374,0.24637362637362514
2023,137,1277,72,1425,62,N,0,10,7,10,-3,1,10,-3,0.03640350877193299,-0.34681020733653156,0.888237639553429,-0.39453748006379286,-2.135207336523125,-3.2133971291866033,-1.3427432216905917,0.3670255183413076,1.604306220095694,-1.5998006379585323,-2.2005183413078147,-2.1984848484848483,-0.8990430622009598
2023,137,1338,59,1235,41,N,0,18,11,6,5,-1,-18,-5,-0.5547478836952493,-0.36492454913507544,-2.331615752668384,-5.82903938167096,-3.8748619801251376,-3.6159366948840628,1.433474420316525,-2.7314133235185842,0.10443503864556547,1.7796282664703718,3.3840633051159372,-0.9700036805299965,2.5220831799779155
2023,137,1388,63,1433,51,N,0,12,5,12,-7,1,12,-7,0.5669841269841278,1.4950264550264478,1.5575661375661376,2.2053968253968286,-2.7313227513227503,-3.854391534391535,0.7466666666666679,-0.30730158730158763,0.26888888888889007,-2.6861375661375675,-1.6767195767195764,-1.6593650793650796,-0.051005291005289166
2023,137,1395,72,1113,70,N,0,2,6,11,-5,-1,-2,5,-2.4870129870129887,1.3003246753246671,1.9312770562770556,6.276515151515152,-1.370670995670995,-2.058982683982684,-0.5595238095238084,0.7267316017316006,-1.9280303030303045,-0.3279220779220786,-0.616883116883117,-0.1737012987012978,2.316017316017316
2023,137,1462,72,1244,67,N,0,5,3,14,-11,-1,-5,11,-3.597101449275364,-4.11951690821256,0.7708333333333339,2.179299516908216,1.107028985507247,3.440144927536231,-0.9690821256038644,-2.4519685990338154,-3.9319202898550714,-0.03780193236715057,0.5833937198067636,-0.0903019323671499,4.166074879227054
2023,138,1104,73,1268,51,N,0,22,1,8,-7,1,22,-7,1.8163382594417072,4.8887110016420365,2.119909688013136,6.556157635467983,3.2685960591132996,4.189696223316915,2.288423645320197,5.66888341543514,1.5415435139573077,4.956034482758621,0.29445812807881744,0.9248357963875202,3.3653530377668304
2023,138,1116,72,1242,71,N,0,1,8,1,7,1,1,7,1.1829568579568601,-0.5390415140415072,-1.3899063899063906,-4.482356532356533,2.6019332519332536,4.743355718355716,0.7345746845746834,-0.3532661782661748,-1.9540903540903507,-0.7087505087505086,-0.07292429792429722,1.8916463166463169,2.878663003663007
2023,138,1222,81,1120,64,N,0,17,1,9,-8,-1,-17,8,0.6354838709677431,-1.8508064516128968,-0.016129032258064946,0.29059139784946453,1.5088709677419363,0.6303763440860202,-3.4857526881720435,-1.5669354838709708,1.556451612903226,2.7747311827956977,0.27473118279569775,-0.29650537634408636,1.1776881720430126
2023,138,1343,78,1281,63,N,0,15,15,7,8,-1,-15,-8,-0.5519005847953267,1.1695906432748515,-0.08918128654970836,1.2580409356725148,1.0029239766081872,-0.18311403508771917,-0.19919590643274887,-5.771198830409357,0.872441520467838,-0.43201754385964897,4.974415204678364,-0.37280701754386003,2.2174707602339154
2023,138,1361,75,1202,52,N,0,23,5,13,-8,-1,-23,8,3.0503663003662993,2.446199633699635,3.4652014652014653,8.39239926739927,-1.1611721611721624,-0.9864926739926752,0.16460622710622808,0.4480311355311315,4.158653846153847,-0.20924908424908395,-0.5306776556776551,0.1430860805860812,-0.24771062271062405
2023,138,1397,65,1181,52,N,0,13,4,5,-1,-1,-13,1,0.2369983277591956,-1.077006688963209,-1.4066889632107014,-3.6974498327759164,0.44046822742474845,-0.3803929765886309,-0.43369565217391326,0.3452759197324369,-2.5605769230769226,1.4766304347826082,-2.225418060200669,0.5615384615384618,-1.7154264214046826
2023,138,1400,71,1336,66,N,0,5,2,10,-8,-1,-5,8,-1.9401223776223766,-3.642482517482513,2.7185314685314674,5.301136363636363,-5.534527972027973,-7.069055944055947,-2.864510489510489,3.1062062937062933,-2.3693181818181817,-2.3645104895104883,-3.267045454545455,-1.142045454545455,-3.05812937062937
2023,138,1417,68,1321,63,N,0,5,2,7,-5,-1,-5,5,-3.065323182564562,-3.3563815494850004,1.47490670249291,5.789431258396775,0.8735333631885371,0.4768920734437998,-1.3672339155097788,0.8203911031497242,-1.075160471712195,-0.8974473802060015,-0.1544260337363781,0.4908344529034183,0.308702791461414
2023,139,1163,70,1388,55,N,0,15,4,5,-1,1,15,-1,2.5810714285714305,5.377857142857145,1.3539285714285718,4.756428571428568,1.1046428571428581,0.21999999999999886,3.2746428571428545,1.3985714285714295,4.307142857142855,2.3500000000000014,-0.864642857142857,1.3471428571428574,2.4060714285714297
2023,139,1166,85,1124,76,N,0,9,6,3,3,-1,-9,-3,-1.6443722943722925,-1.7933982683982705,1.0837662337662337,1.0469696969696969,3.0312770562770552,4.512337662337661,2.1208874458874476,-7.117748917748916,-1.5905844155844147,1.2212121212121225,1.0676406926406932,-1.9961038961038953,4.197186147186148
2023,139,1194,78,1192,70,N,0,8,9,16,-7,-1,-8,7,-0.09100743745774054,-0.46274509803921404,-1.5710615280594995,-3.639215686274511,2.6612576064908726,2.271467207572684,1.0965517241379317,-3.251926977687628,0.09499661933739034,0.20554428668019042,1.7336037863421234,-0.2809330628803246,3.1407031778228536
2023,139,1211,84,1395,81,N,0,3,3,6,-3,1,3,-3,2.1227513227513235,-0.2335978835978949,1.8779100529100532,1.8351851851851855,-0.21402116402116178,-0.2920634920634946,-1.6215608465608469,1.279761904761905,-1.4490740740740744,-0.7939153439153444,-1.370502645502646,-1.3853174603174603,0.9755291005291014
2023,139,1243,75,1246,69,N,0,6,3,6,-3,1,6,-3,-1.2234142668925259,-2.944193487671747,0.9284145805884938,2.992188970449842,1.9608507434594404,0.9567726959031297,-3.296097622184579,-0.5275738753999626,1.0415960850743442,3.6193613150134887,1.2063178367526186,-1.1334776334776335,1.6413200326243818
2023,139,1274,85,1231,69,N,0,16,5,4,1,-1,-16,-1,-0.7324675324675312,-1.9370129870129844,-1.8632467532467532,-5.434285714285714,-0.8531168831168827,0.05597402597402379,-0.3329870129870116,2.608961038961038,1.4620779220779223,1.1116883116883116,-1.7200000000000006,1.3762337662337663,2.0810389610389635
2023,139,1277,69,1266,60,N,0,9,7,2,5,-1,-9,-5,3.742167919799499,4.534147869674186,1.3759398496240607,6.9151002506265655,-0.5307017543859658,0.1791979949874687,0.3543233082706774,-4.124060150375939,1.5708020050125313,0.08583959899749338,4.476817042606516,0.125,0.7584586466165426
2023,139,1462,84,1338,73,N,0,11,3,11,-8,-1,-11,8,-3.2621212121212153,-3.3705050505050522,1.5151515151515156,6.052323232323232,2.1915151515151514,2.373939393939395,-0.19141414141414081,-1.7837373737373738,-4.452424242424243,-1.6025252525252522,-1.0616161616161621,1.0892929292929292,1.2735353535353546
2023,143,1163,88,1116,65,N,0,23,4,8,-4,-1,-23,4,0.040192307692308304,-3.1076923076923038,-3.5871153846153856,-9.245769230769227,1.8132692307692313,4.16346153846154,-3.6782692307692297,0.19038461538461604,-3.276153846153843,-0.2376923076923081,2.2171153846153846,0.8573076923076925,1.0421153846153857
2023,143,1194,62,1397,55,N,0,7,9,4,5,1,7,5,2.9445027486256876,3.599275362318842,1.6052473763118442,2.2304347826086968,-2.3791604197901055,-2.6843828085957036,-2.288580709645178,0.2104947526236849,-2.0793103448275865,-0.3085707146426788,-2.0087956021989006,-1.2563218390804596,-1.6954772613693159
2023,143,1211,79,1417,76,N,0,3,3,2,1,1,3,1,2.793358876117498,-2.3832694763729307,1.1780332056194132,1.4265644955300125,2.3878671775223523,3.8601532567049794,-2.23933588761175,2.2229885057471286,0.45466155810983544,1.4807151979565774,-1.1683269476372926,-0.27164750957854444,1.5044699872286103
2023,143,1243,98,1277,93,N,1,5,3,7,-4,1,5,-4,0.28823417238749016,0.8123569794050383,0.00835875921688256,3.075038138825324,3.6341533180778036,4.923849478769387,1.7871217899822032,-1.4638634630053389,1.477116704805491,4.19600177981185,3.138221459445715,-0.22222222222222188,1.2823544368166822
2023,144,1166,86,1343,75,N,0,11,6,15,-9,1,11,-9,0.2229010025062621,0.9771303258145352,0.27490601503759393,0.9594298245614006,0.3342731829573946,-1.5253759398496243,-0.7864974937343376,1.509555137844611,2.313909774436091,-0.3278508771929829,0.4724310776942362,1.174812030075187,-2.8400689223057647
2023,144,1274,89,1222,75,N,0,14,5,1,4,-1,-14,-4,-3.683102918586787,0.4781874039938572,-0.9152995391705065,-0.299877112135178,-0.1324423963133654,2.8460522273425504,5.071705069124425,1.7524116743471616,-1.4807373271889404,-1.1009216589861754,0.35526881720430126,1.738648233486943,3.1768356374807993
2023,144,1361,71,1104,64,N,0,7,5,1,4,-1,-7,-4,1.3309902740937218,3.671220159151197,2.88868258178603,7.871175950486297,1.8395667550839931,2.3192749778956667,2.5869584438549946,5.602033598585322,1.0662687886825832,4.068213969938109,-1.5576480990274089,1.416136162687887,1.8854995579133522
2023,144,1400,83,1462,71,N,0,12,2,3,-1,1,12,-1,-1.1349358974358985,-0.049700854700859054,0.27564102564102644,2.891047008547009,2.1089102564102564,2.0601282051282084,-0.4527777777777775,-3.720363247863247,-1.8942948717948713,-1.5561965811965823,1.2736111111111112,0.6509188034188034,3.455790598290598
2023,145,1163,82,1211,54,N,0,28,4,3,1,1,28,1,-2.411203703703702,0.7824074074074119,1.5210185185185185,5.979814814814812,-0.5065740740740754,-2.022222222222222,4.267870370370369,-0.5833333333333357,2.237407407407405,1.5596296296296295,-0.7667592592592589,1.0988888888888892,1.4026851851851845
2023,145,1194,79,1243,76,N,0,3,9,3,6,1,3,6,2.0742128935532236,4.442028985507243,2.377228052640346,5.137681159420289,-5.1864067966017,-5.5049142095618855,0.05755455605530457,0.6626686656671659,-1.4880059970014994,-3.7257204730967857,-2.036814925870398,-0.46743295019157083,-2.1928202565384005
2023,146,1274,88,1400,81,N,0,7,5,2,3,1,7,3,0.582554945054941,-0.6337912087912088,-0.010879120879121018,-0.8589835164835158,-1.0870054945054939,-1.7648901098901106,-0.019285714285715017,0.8276648351648355,-2.2247527472527473,-0.5898351648351632,-0.34249999999999936,-0.0969505494505496,-3.8542032967032966
2023,146,1361,57,1166,56,N,0,1,5,6,-1,-1,-1,1,2.431318681318679,2.568223443223445,2.6199633699633704,5.160256410256409,-1.7028388278388285,-3.0073260073260073,-0.9217032967032974,4.504578754578752,3.780677655677655,-0.17948717948718063,-1.875915750915751,1.0924908424908422,-4.206043956043956
2023,152,1163,72,1274,59,N,0,13,4,5,-1,1,13,-1,-1.82178571428571,0.36071428571428754,1.271071428571429,4.630714285714284,0.1189285714285706,0.7514285714285691,4.391785714285714,0.9271428571428579,2.655714285714284,2.387142857142857,-1.3275000000000006,1.1271428571428572,3.4803571428571445
2023,152,1361,72,1194,71,N,0,1,5,9,-4,-1,-1,4,3.2539787798408497,5.455128205128204,3.4093722369584434,6.7435897435897445,-4.236295313881522,-4.648541114058357,0.5329354553492482,1.3572060123784233,2.3835101679929256,-0.36052166224579985,-1.334659593280283,-0.978116710875331,-1.6547303271441223
2023,154,1163,76,1361,59,N,0,17,4,5,-1,1,17,-1,2.0476282051282055,3.5634615384615387,2.7153205128205133,5.808589743589742,-1.0722435897435911,-1.5358974358974393,4.2603205128205115,0.8141025641025621,4.592820512820511,1.4671794871794877,-1.1203205128205127,1.2882051282051288,0.9995512820512822
