Season,DayNum,WTeamID,WScore,LTeamID,LScore,WLoc,NumOT,ScoreDiff,WSeed,LSeed,SeedDiff,flip,ScoreDiffAdj,SeedDiffAdj,FGMDiffAdj,FGADiffAdj,FGM3DiffAdj,FGA3DiffAdj,FTMDiffAdj,FTADiffAdj,ORDiffAdj,DRDiffAdj,AstDiffAdj,TODiffAdj,StlDiffAdj,BlkDiffAdj,PFDiffAdj
2010,138,3124,69,3201,55,N,0,14,4,13,-9,1,14,-9,0.18317230273752472,-5.679146537842186,-5.816022544283413,-16.112721417069242,5.048711755233494,6.271739130434785,-1.1924315619967807,6.2773752012882476,0.5656199677938787,2.2286634460547496,-2.707326892109501,4.203301127214171,-2.5623993558776164
2010,138,3173,67,3395,66,N,0,1,8,9,-1,1,1,-1,0.5731601731601721,-0.24853896103896034,-2.160064935064935,-2.4108225108225128,-0.7624999999999993,0.30568181818182083,1.2341450216450234,1.3169372294372295,-2.116720779220781,0.3501623376623364,-1.7679112554112564,0.525919913419914,0.6384199134199164
2010,138,3181,72,3214,37,H,0,35,2,15,-13,1,35,-13,2.769324827219563,5.000053163211064,-0.3099237993974828,-0.693779904306222,-0.8309232677653728,-0.005369484316851469,3.809002303739147,0.82185007974482,1.2979975190501527,2.1127591706539057,1.925979089136984,2.3065390749601278,-0.7024809498493738
2010,138,3199,75,3256,61,H,0,14,3,14,-11,1,14,-11,-1.7711956521739154,-1.6369565217391226,1.709565217391304,6.284021739130434,-1.977717391304349,-3.7198913043478257,0.9719565217391324,-3.164021739130437,0.7904347826086955,2.0709782608695626,1.7669565217391305,-0.0007608695652172592,0.555434782608696
2010,138,3207,62,3265,42,N,0,20,5,12,-7,1,20,-7,0.24336080586080655,7.058836996337,-0.8988095238095237,0.6240842490842482,-0.446199633699635,1.559981684981686,6.808836996336996,-6.37797619047619,0.3988095238095237,2.5034340659340657,5.756639194139195,-2.1524725274725274,5.51945970695971
2010,138,3208,64,3408,59,N,0,5,5,12,-7,1,5,-7,-2.0456382385730194,-0.10723244147156663,-1.1197742474916383,-0.07023411371237387,-1.8787625418060205,-2.1989966555183926,2.3818283166109264,2.422798216276476,-3.470108695652174,-2.2522296544035676,-4.545080824972129,1.618380713489409,-2.91826923076923
2010,138,3211,82,3314,76,H,0,6,7,10,-3,1,6,-3,2.403619528619526,-3.0353535353535364,0.1363636363636367,-0.5542929292929308,-3.172558922558922,-6.883838383838384,-4.84090909090909,-3.59090909090909,3.341750841750841,-2.8093434343434325,-0.2386363636363633,-1.2184343434343425,-2.409511784511782
2010,138,3234,70,3353,63,N,0,7,8,9,-1,1,7,-1,3.240039200565519,4.878526444315909,4.548293811451706,9.593470856628754,1.1245260587365848,-0.35017029753871753,-0.46438210911895084,1.4081035923141165,1.9913083992031346,-0.7642021720969083,-2.025335775335776,-0.4027215474583894,-3.052213868003342
2010,138,3246,83,3251,77,H,0,6,4,13,-9,1,6,-9,0.4282142857142901,8.183571428571433,2.164642857142857,7.000357142857144,3.428809523809523,3.857619047619046,-1.4291666666666654,-0.53857142857143,0.7083333333333339,-3.7922619047619044,1.3065476190476186,1.6932142857142862,0.44238095238095454
2010,138,3261,60,3216,39,N,0,21,7,10,-3,-1,-21,3,-4.422222222222221,-6.375,1.0546296296296287,6.887037037037036,-2.3574074074074076,-2.4527777777777793,-1.7833333333333332,1.0342592592592617,-2.9129629629629648,2.90185185185185,-1.9842592592592592,1.723148148148148,-0.3740740740740751
2010,138,3277,72,3132,62,N,0,10,5,12,-7,-1,-10,7,0.31397306397306224,0.03451178451178549,3.864478114478114,8.06228956228956,-0.26346801346801385,-2.6641414141414153,-1.7340067340067336,-3.3350168350168374,-0.10690235690235639,-2.058080808080806,0.2474747474747483,-3.2819865319865325,-2.5917508417508444
2010,138,3329,70,3151,63,N,0,7,4,13,-9,-1,-7,9,-4.151515151515156,-6.710227272727273,1.395075757575758,3.048484848484847,-0.24318181818181728,-0.6833333333333371,-2.1988636363636367,2.730681818181818,0.5640151515151501,3.01060606060606,0.28787878787878896,-1.435606060606061,-3.946590909090908
2010,138,3385,65,3343,47,N,0,18,6,11,-5,-1,-18,5,-1.2532051282051242,-2.8798076923076934,0.6137820512820511,5.653846153846153,-0.95673076923077,-4.854166666666664,-0.7419871794871788,-0.9855769230769234,-1.0929487179487172,0.4423076923076934,-0.1426282051282044,0.6121794871794868,0.1490384615384599
2010,138,3390,79,3415,47,H,0,32,1,16,-15,1,32,-15,4.485515496521188,3.339658444022774,0.2774193548387096,-1.6098671726755214,0.44750158127767214,-0.11087919038583038,-0.3384566729917786,2.545730550284631,0.17628083491461233,-2.028273244781783,-4.484629981024667,-1.4586970271979758,-4.502340290955093
2010,138,3397,75,3122,42,H,0,33,1,16,-15,-1,-33,15,-1.6421568627451002,0.5549019607843135,0.16568627450980333,2.5784313725490193,6.421568627450981,9.591176470588236,0.764705882352942,0.5901960784313758,-2.469607843137254,2.120588235294118,1.3352941176470585,-2.6235294117647054,0.9970588235294073
2010,138,3401,84,3340,53,N,0,31,2,15,-13,-1,-31,13,-1.8795238095238105,-0.2466666666666697,2.8119047619047617,8.983333333333333,-0.4814285714285713,-1.2461904761904758,-0.5680952380952373,0.006190476190475636,0.5961904761904755,0.38904761904762,-0.19142857142857217,-0.41714285714285726,-3.4595238095238052
2010,139,3114,63,3210,53,N,0,10,11,6,5,1,10,5,1.786417688591598,-1.2778706800445931,0.6950947603121516,-0.13377926421404673,-4.838814567075437,-5.537997027127462,-4.10098476402824,-2.221200297287254,-0.48039762170196987,-6.5048309178743935,-1.8547008547008552,-0.16796729840208124,0.027591973244149415
2010,139,3163,95,3380,39,N,0,56,1,16,-15,1,56,-15,10.86607142857143,1.5684523809523796,2.0773809523809526,3.1875,2.040178571428571,0.29613095238095255,-3.217261904761905,8.047619047619047,9.21577380952381,-6.6175595238095255,-2.3125,2.6101190476190474,-9.672619047619047
2010,139,3235,79,3250,42,H,0,37,4,13,-9,1,37,-9,-0.5409523809523833,-4.747619047619047,1.9952380952380953,1.404761904761905,-1.913333333333334,-4.6266666666666705,0.4076190476190469,-0.759047619047621,-0.1542857142857148,-1.4047619047619087,-2.734285714285714,-0.19619047619047603,-0.7914285714285736
2010,139,3280,68,3292,64,N,0,4,7,10,-3,1,4,-3,-0.5496491228070184,3.3571929824561337,-1.596578947368421,-3.5853508771929796,0.7937719298245618,1.6964035087719314,2.1176315789473676,3.03736842105263,-0.5285087719298254,-1.4894736842105267,-0.9623684210526324,1.8898245614035085,-1.2324561403508767
2010,139,3304,83,3320,44,N,0,39,1,16,-15,1,39,-15,1.2577586206896534,1.7152298850574752,0.0824712643678156,-0.1170977011494223,3.708764367816091,9.940373563218387,1.094396551724138,-1.290517241379309,1.3406609195402304,-1.4862068965517228,2.446623563218391,2.28441091954023,-3.086422413793102
2010,139,3323,86,3156,58,H,0,28,2,15,-13,-1,-28,13,-1.8746438746438763,-4.6924501424501415,1.0868945868945863,4.477065527065527,0.38803418803418666,1.1792022792022792,0.016381766381767804,-0.7524216524216527,0.5890313390313384,0.9417378917378905,-1.9267806267806264,-1.7519943019943023,-2.543304843304842
2010,139,3326,93,3384,59,N,0,34,2,15,-13,1,34,-13,0.46946778711484427,-2.299089635854344,-0.7999299719887958,-2.3549019607843107,3.3919467787114836,1.9461484593837497,-1.980672268907563,4.4935574229691895,1.1315826330532222,-1.0172268907563016,-2.334103641456582,1.8155462184873952,-5.6950280112044815
2010,139,3328,68,3355,57,H,0,11,3,14,-11,1,11,-11,0.7551414768806097,8.49313319530711,-3.0847135955831604,-4.467701863354041,-2.790752242926155,-3.895341614906833,3.266356107660455,1.0823326432022071,-3.3005521048999285,-3.7548654244306405,-2.579710144927537,-0.062491373360938685,-0.6915113871635619
2010,139,3361,74,3400,63,A,0,11,11,6,5,1,11,5,0.345887445887449,-2.8796536796536856,-2.1335497835497836,-4.133982683982683,-5.6324675324675315,-8.144805194805198,0.06731601731601877,-5.837878787878793,2.3703463203463198,1.9287878787878796,1.3372294372294355,-1.0478354978354982,-0.5019480519480517
2010,139,3396,65,3241,53,N,0,12,8,9,-1,-1,-12,1,1.7836538461538467,4.258012820512818,0.5881410256410264,3.040064102564102,3.5560897435897445,3.685897435897438,1.2387820512820547,1.8782051282051277,-0.5929487179487172,-1.0160256410256387,-1.5737179487179498,0.3429487179487176,1.9198717948717956
2010,139,3417,74,3301,54,N,0,20,8,9,-1,-1,-20,1,-1.4981643356643346,0.6290209790209786,1.5352272727272727,3.197202797202797,3.630332167832167,1.9307692307692292,-1.100524475524475,1.9248251748251768,-1.40777972027972,1.920979020979022,0.30611888111888064,-0.36005244755244803,-1.6236888111888135
2010,139,3435,83,3177,76,N,1,7,6,11,-5,-1,-7,5,-0.014285714285712459,3.8971861471861473,-0.6896103896103893,1.4510822510822479,0.014935064935063025,-1.5517316017316016,1.909523809523808,1.908008658008658,1.1077922077922082,1.2480519480519483,2.311471861471862,1.733766233766234,-0.8019480519480489
2010,139,3436,64,3458,55,N,0,9,10,7,3,1,9,3,-1.5680952380952355,3.691904761904759,0.3461904761904764,1.732380952380952,1.767142857142856,1.3500000000000014,2.447619047619046,-1.2861904761904768,-1.5961904761904755,-2.3390476190476193,0.5647619047619035,-0.23000000000000043,-2.653333333333334
2010,139,3452,58,3249,43,N,0,15,3,14,-11,-1,-15,11,4.379761904761903,8.598214285714292,1.605952380952381,7.945833333333335,0.5952380952380967,0.12678571428571672,0.12380952380952337,1.8964285714285687,4.0005952380952365,-0.49464285714285694,-0.9023809523809518,-1.4797619047619044,1.2261904761904745
2010,139,3453,69,3438,67,N,0,2,12,5,7,-1,-2,-7,-0.29594017094017033,8.452075702075703,-2.9761904761904763,-5.0883699633699635,0.5865384615384617,2.7223748473748444,3.2541208791208778,5.482142857142858,-6.35164835164835,-0.11126373626373365,0.4406288156288145,2.1314102564102564,1.6230158730158735
2010,139,3462,94,3190,82,H,0,12,3,14,-11,-1,-12,11,2.7128623188405783,10.184225195094754,1.0727424749163879,4.138238573021184,3.5886984392419183,2.2247073578595327,3.7385033444816074,-1.0234810479375724,-0.05776198439241931,1.884824414715716,3.5830546265328884,-1.6084866220735785,2.553929765886288
2010,140,3124,49,3207,33,N,0,16,4,5,-1,1,16,-1,1.8197463768115973,-5.334239130434774,-3.3484299516908216,-11.219202898550723,3.120471014492754,3.9522946859903385,-5.1530797101449295,11.455615942028984,-1.3278985507246386,0.2726449275362306,-6.177234299516909,4.143115942028986,-5.00452898550725
2010,140,3181,60,3261,52,H,0,8,2,7,-5,1,8,-5,-0.030555555555555003,4.155555555555566,0.6296296296296298,3.1416666666666657,-2.148148148148147,-1.2611111111111093,4.8157407407407415,-1.1027777777777743,-1.8703703703703702,5.913888888888888,3.4814814814814827,0.6055555555555561,3.4351851851851833
2010,140,3199,66,3385,65,H,1,1,3,6,-3,1,1,-3,-0.14166666666666572,0.012500000000002842,1.319166666666666,6.890000000000001,0.4624999999999986,-2.794166666666662,0.8641666666666694,0.9175000000000004,0.951666666666668,3.34,-0.9241666666666664,0.4983333333333331,1.7375000000000007
2010,140,3208,74,3329,71,N,1,3,5,4,1,1,3,1,-3.8317687747035585,-5.764575098814227,-1.3096343873517782,-1.9768774703557312,-1.9007905138339911,-0.9913043478260875,0.45059288537549413,-0.973122529644268,0.19807312252964415,3.0468379446640323,1.4735671936758896,1.666749011857707,-3.446590909090908
2010,140,3211,72,3401,71,N,0,1,7,2,5,1,1,5,2.213994708994708,2.0739682539682605,0.18571428571428505,1.807539682539682,1.1706878306878306,0.31174603174603277,-0.6633333333333322,-0.7025396825396832,3.647248677248676,1.8307142857142864,0.868492063492063,-0.6461111111111109,-2.715211640211635
2010,140,3246,70,3277,52,H,0,18,4,5,-1,1,18,-1,0.3945021645021676,2.456046176046179,0.05088023088023075,0.8714430014430015,2.514415584415584,2.77125541125541,-0.8247474747474737,-3.736551226551228,-3.127272727272727,-1.7072871572871549,4.094300144300145,-2.3225685425685425,-0.0419624819624822
2010,140,3390,96,3234,67,H,0,29,1,8,-7,-1,-29,7,-3.2600888076270067,0.46160376126420033,2.1565887423272816,5.556092464411652,0.1599843280658213,-0.5808410604675451,1.8532062165338914,-1.083191850594229,-0.9025728091942025,1.5713073005093356,2.6488833746898264,1.6125114274520045,2.2393887945670627
2010,140,3397,92,3173,64,H,0,28,1,8,-7,-1,-28,7,0.02619047619047521,2.6571428571428513,0.8119047619047617,4.695238095238093,2.866666666666667,4.15,0.6095238095238109,0.547619047619051,-0.2928571428571445,1.0119047619047592,1.7142857142857135,-1.6714285714285708,0.8452380952380949
2010,141,3163,90,3396,36,N,0,54,1,8,-7,1,54,-7,9.1875,2.0833333333333286,0.5208333333333339,1.0,2.197916666666668,1.3645833333333357,-2.520833333333332,6.375,8.010416666666668,-2.7604166666666643,0.8333333333333321,1.7916666666666665,-4.895833333333332
2010,141,3235,60,3453,56,H,0,4,4,12,-8,1,4,-8,-1.9546703296703285,-1.5796703296703285,1.2619047619047619,2.292582417582416,-3.580128205128206,-3.6506410256410273,-0.26968864468864595,5.839285714285715,-3.8040293040293047,-1.2541208791208796,-5.781593406593408,0.6552197802197803,-1.488095238095239
2010,141,3280,87,3326,67,N,0,20,7,2,5,1,20,5,-0.24298245614035352,3.5355263157894683,0.5517543859649123,5.751315789473686,-4.474561403508771,-4.2219298245614,1.9776315789473689,-3.8192982456140356,-1.3701754385964922,-0.33947368421052815,1.9192982456140344,-0.020175438596491624,4.559210526315791
2010,141,3304,83,3417,70,N,0,13,1,8,-7,1,13,-7,0.6134404388714749,0.4455329153605021,3.4343652037617547,8.793887147335424,7.416340125391848,10.711206896551722,-2.634012539184951,0.6708463949843271,1.7255094043887151,-2.4498432601880875,-0.3115203761755492,1.8732366771159876,-5.115399686520377
2010,141,3323,84,3436,66,H,0,18,2,10,-8,1,18,-8,3.644814814814815,4.605185185185185,-0.6329629629629627,-0.9874074074074066,1.0122222222222224,1.753703703703703,1.6425925925925924,0.23037037037036967,4.140370370370372,2.6940740740740736,3.388148148148149,1.011481481481482,1.905185185185184
2010,141,3328,60,3114,44,H,0,16,3,11,-8,-1,-16,8,-0.8928093645484978,-5.394537346711253,-1.482441471571906,-5.6018952062430305,-2.5349498327759203,-2.3107023411371213,-1.6244147157190643,-3.897045707915275,1.0365105908584162,-3.126086956521739,2.0027870680044586,-0.9619286510590861,0.027591973244149415
2010,141,3361,64,3452,55,N,0,9,11,3,8,1,9,8,3.5880952380952387,0.9511904761904759,-0.6309523809523814,-0.15833333333333321,-1.5857142857142854,-3.5857142857142854,-0.2333333333333325,-1.0083333333333364,3.9369047619047617,1.836904761904762,-1.2630952380952394,0.20476190476190492,0.02499999999999858
2010,141,3462,63,3435,62,H,0,1,3,6,-3,-1,-1,3,0.5803030303030283,-1.2406759906759888,0.5150349650349648,0.7376456876456885,-0.3200466200466181,-2.0814685314685306,-1.2031468531468512,-3.879953379953381,0.1343822843822835,0.03566433566433602,1.1834498834498834,-2.4125874125874125,2.39335664335664
2010,145,3124,77,3397,62,A,0,15,4,1,3,1,15,3,-0.3427536231884041,-1.9550724637681114,-1.6567632850241543,-3.0942028985507264,6.4579710144927525,8.260628019323674,-1.9405797101449274,4.534782608695654,0.7137681159420275,0.5934782608695635,0.3352657004830917,1.2014492753623198,-1.9586956521739154
2010,145,3181,66,3361,58,N,0,8,2,11,-9,1,8,-9,-0.5150793650793659,7.25793650793652,0.33439153439153557,2.0476190476190474,3.0661375661375665,4.974603174603178,4.843121693121693,1.81666666666667,-3.1235449735449716,-1.0500000000000007,2.912433862433865,-0.6142857142857139,2.116931216931217
2010,145,3390,73,3208,36,H,0,37,1,5,-4,-1,-37,4,-5.52165147265077,-0.7579768583450175,-1.0279628330995791,1.536465638148666,-0.7987377279102379,1.0764375876577859,4.345021037868163,-2.592917251051894,-3.284624824684432,0.2566619915848527,3.7448281907433376,2.103699158485273,1.933467741935484
2010,145,3462,74,3211,56,N,0,18,3,7,-4,-1,-18,4,5.3935185185185155,7.893162393162399,-0.5576923076923075,0.037393162393161816,-0.24715099715099598,-2.6880341880341874,0.35897435897436125,-3.104700854700855,4.065527065527064,0.7788461538461533,4.127136752136753,-0.7168803418803416,1.660612535612536
2010,146,3163,74,3235,36,N,0,38,1,4,-3,1,38,-3,8.964285714285715,7.526785714285715,-2.136904761904762,-4.758928571428569,1.8854166666666679,3.114583333333334,1.0773809523809526,5.910714285714285,5.849702380952381,-0.14732142857142705,4.589285714285714,3.142857142857143,-3.199404761904761
2010,146,3199,74,3280,71,N,0,3,3,7,-4,1,3,-4,-0.49035087719298076,-2.177192982456134,-1.403421052631579,-4.09464912280702,2.766228070175437,3.1235964912280707,0.5823684210526334,1.2826315789473703,0.1885087719298255,3.1294736842105273,-0.9976315789473684,-0.3898245614035085,0.5324561403508774
2010,146,3246,76,3304,67,N,0,9,4,1,3,1,9,3,-0.7170443349753661,2.0016748768472894,-2.046995073891625,-4.099211822660099,-1.6007881773399006,-4.511921182266008,0.6931034482758616,-0.223054187192119,-3.244827586206897,1.214778325123154,2.3995073891625616,-0.8391133004926106,4.380886699507389
2010,146,3328,77,3323,72,N,1,5,3,2,1,-1,-5,-1,-0.28953301127214104,-0.2619162640901749,-0.060789049919484306,-1.0682769726247976,0.3526570048309168,0.6276167471819676,0.06433172302737411,-2.5484702093397757,1.9645732689210949,-0.5186795491143315,4.861191626409017,1.1169887278582933,-0.2090177133655402
2010,147,3124,51,3181,48,N,0,3,4,2,2,1,3,2,-0.2038647342995148,-8.510628019323676,-2.1363929146537846,-5.9275362318840585,3.8394524959742338,3.621739130434783,-7.147987117552336,7.201449275362318,1.189694041867952,-1.723188405797103,-5.779549114331724,2.3347826086956527,-4.482769726247987
2010,147,3390,55,3462,53,H,0,2,1,3,-2,1,2,-2,3.1747311827956963,0.7981803143093487,0.6197270471464025,1.156120760959471,0.5097187758478086,-2.0446650124069485,-2.8157568238213386,-0.041976840363936674,0.9170802315963602,-1.2332506203473947,-2.0014474772539286,-1.9404466501240694,-2.909429280397024
2010,148,3163,90,3199,50,N,0,40,1,3,-2,1,40,-2,6.850000000000001,-0.38750000000000284,0.28500000000000014,-1.3275000000000006,-0.6812499999999986,-1.2787500000000023,-2.6350000000000016,5.145,5.30875,-4.55875,1.1950000000000003,1.96,-5.237500000000001
2010,148,3328,88,3246,68,N,0,20,3,4,-1,-1,-20,1,-1.838633540372669,-1.8718633540372593,0.07931677018633554,-0.19801242236024663,3.867577639751552,5.8981987577639785,-0.1282608695652172,-3.540745341614908,-1.6391304347826097,-0.4975155279503092,4.898757763975155,1.1078881987577645,1.4648447204968953
2010,153,3163,70,3124,50,N,0,20,1,4,-3,-1,-20,3,-6.9094202898550705,-4.16757246376811,-3.2650966183574877,-7.2400362318840585,3.172554347826086,4.129378019323674,-1.2989130434782616,-0.19021739130434767,-6.0049818840579725,1.9288949275362306,-3.0730676328502415,1.2681159420289863,1.828804347826086
2010,153,3390,73,3328,66,N,0,7,1,3,-2,-1,-7,2,-1.6537166900420743,4.564305750350627,-1.0795932678821885,0.10603085553997005,0.1534361851332413,0.6438288920056081,3.2863253856942496,-0.5994389901823283,-1.8253856942496487,1.0131837307152871,2.812762973352034,0.1075035063113603,4.631837307152875
2010,155,3163,53,3390,47,N,0,6,1,1,0,1,6,0,3.991935483870968,2.796370967741936,-0.052419354838709964,0.9576612903225801,0.7026209677419359,1.2489919354838719,2.883064516129032,3.673387096774192,4.904233870967742,-0.831653225806452,5.600806451612903,2.7096774193548385,-0.566532258064516
2011,138,3177,56,3298,43,N,0,13,3,14,-11,1,13,-11,4.873737373737374,7.891414141414138,-0.7188552188552189,-1.9898989898989896,3.148148148148149,3.878787878787879,0.826599326599327,-2.234848484848488,2.0218855218855225,1.1624579124579117,3.68013468013468,0.8872053872053876,5.789562289562291
2011,138,3181,90,3404,45,H,0,45,2,15,-13,1,45,-13,-0.5278325123152712,0.9385878489326771,-3.446305418719212,-9.780459770114941,-3.0597701149425287,-2.458784893267648,3.2350574712643656,-4.632922824302135,0.3450738916256135,0.030377668308702255,3.500738916256159,1.7695402298850578,0.8160919540229905
2011,138,3210,69,3132,58,N,0,11,5,12,-7,-1,-11,7,-1.6563664596273284,-1.5169254658385114,3.234006211180125,8.010714285714284,2.219875776397517,-0.8656832298136656,-2.628881987577641,0.4950310559006219,-0.8180124223602476,-4.765993788819875,-2.845186335403728,0.737732919254658,-2.159472049689443
2011,138,3211,92,3234,86,H,0,6,11,6,5,1,6,5,7.867724867724867,10.68386243386243,-2.823082010582011,-6.2480158730158735,-2.742724867724867,-3.754298941798943,2.1299603174603163,-2.5545634920634903,3.8369708994708986,-1.5489417989417973,4.172949735449735,-0.24007936507936511,3.8511904761904763
2011,138,3246,66,3214,62,N,1,4,4,13,-9,-1,-4,9,-1.9358333333333277,-5.530000000000001,0.2525000000000004,-1.3858333333333306,-3.2774999999999963,-3.935833333333335,-1.5416666666666643,1.6083333333333343,0.9783333333333317,-0.9991666666666674,-1.8574999999999982,-0.27000000000000046,-0.9583333333333286
2011,138,3265,74,3235,64,N,0,10,10,7,3,-1,-10,-3,1.5076802507837002,-6.191536050156735,0.4661442006269594,-1.8062695924764895,2.711285266457679,3.673667711598746,-0.04858934169278939,1.4518808777429442,0.6896551724137936,4.910188087774296,-3.6141065830721004,-2.0136363636363637,-0.42366771159874617
2011,138,3266,68,3400,65,N,0,3,8,9,-1,1,3,-1,-3.450096813941208,-8.595229713078695,-1.5684298538989614,-2.2843689491286767,-3.1860477908818865,-5.179930910051048,-3.922790881886991,-3.6221175849322336,2.336648477380743,-0.26701945080091605,1.0939865340609032,-2.4409875022003162,-1.6844745643372647
2011,138,3314,82,3201,68,N,0,14,5,12,-7,-1,-14,7,-2.4236538461538473,-2.5619505494505432,5.3385989010989,12.026181318681319,0.32439560439560466,-0.5800549450549433,0.03593406593406456,-6.1310439560439605,0.004560439560439278,-0.6401923076923062,1.8576648351648366,-3.7457142857142856,-0.18774725274725412
2011,138,3323,67,3428,54,A,0,13,2,15,-13,1,13,-13,7.280311355311355,8.610370879120879,-2.3168040293040293,-7.467673992673994,5.940155677655678,8.011332417582416,4.970398351648351,-0.48514194139194444,3.72474816849817,2.5590201465201474,5.801808608058607,-0.15551739926739927,1.5466346153846118
2011,138,3326,80,3416,69,H,0,11,4,13,-9,1,11,-9,2.0126984126984127,-2.2587301587301596,-0.5706349206349204,-0.6404761904761891,0.3626984126984123,-1.221428571428568,-5.348412698412698,3.013492063492059,4.039682539682541,-1.6492063492063487,-2.629365079365079,2.7746031746031745,-2.8484126984127016
2011,138,3336,75,3173,66,H,0,9,6,11,-5,-1,-9,5,-1.9886724386724417,0.8536796536796558,0.029004329004328255,2.211111111111112,1.0441558441558438,2.2797258297258303,1.6671717171717155,2.307503607503609,2.0373737373737377,0.25584415584415865,-1.7707792207792217,-0.12950937950937913,-1.3132756132756143
2011,138,3385,55,3403,50,N,0,5,9,8,1,1,5,1,-1.3670995670995651,-1.8519480519480496,-1.3411255411255403,-3.773376623376624,0.7625541125541133,1.875757575757575,0.1248917748917755,-1.6729437229437245,-2.103679653679656,-0.18311688311688457,-0.7452380952380953,-0.7551948051948045,-2.663636363636366
2011,138,3390,86,3413,59,H,0,27,1,16,-15,1,27,-15,5.364942528735632,4.964798850574709,0.8196839080459775,-2.8405172413793096,0.16738505747126275,-1.3362068965517224,0.6149425287356323,5.839080459770113,2.170258620689655,-1.3541666666666679,-2.9942528735632195,0.056752873563218564,0.3010057471264389
2011,138,3396,63,3113,45,N,0,18,10,7,3,-1,-18,-3,-3.8788043478260867,-4.376630434782612,-2.804347826086957,-4.326086956521738,2.5820652173913032,1.5891304347826107,0.48967391304347707,-3.4027173913043463,-2.136413043478262,2.592391304347826,-0.0815217391304337,-1.073913043478261,0.36630434782608745
2011,138,3397,99,3391,34,H,0,65,1,16,-15,-1,-65,15,-0.9888936049801949,-10.216822297679684,-1.3082908885116016,-4.408602150537634,0.7156904357668363,-0.13476230899829744,-8.595713073005093,-3.7790039615167004,2.7276457272212795,1.6413412563667258,1.9907328805885678,-0.2864318053197499,-2.3484012450481053
2011,138,3417,55,3285,47,N,0,8,3,14,-11,-1,-8,11,-1.5433904330963166,1.681318681318679,2.487798965740142,6.172592113768585,2.6291208791208778,1.4991111829347155,1.254444085326437,3.6721881060116353,-0.6457659987071764,0.4084518422753689,-1.8136716224951517,0.7277795733678087,-0.6931965093729779
2011,139,3124,66,3341,30,H,0,36,1,16,-15,1,36,-15,4.661674347158218,5.472210585113807,1.5660522273425497,1.3141321044546839,2.771714844295488,5.404412791509568,4.192954894567796,3.6335009076944544,3.6007889959502855,-3.587801982963274,-3.1119955313503693,4.075652841781873,-2.544162826420891
2011,139,3163,75,3216,39,H,0,36,1,16,-15,1,36,-15,4.460661764705883,5.450367647058826,1.327696078431373,4.746691176470591,1.4641544117647065,1.8833946078431367,0.9302083333333329,3.94356617647059,3.6554534313725497,-1.5792279411764714,0.7210784313725487,1.0636642156862743,-0.20827205882352828
2011,139,3199,76,3359,46,N,0,30,3,14,-11,1,30,-11,4.785714285714285,12.909937888198755,-2.670807453416149,-5.16770186335404,5.167701863354038,8.34472049689441,9.378881987577639,1.8944099378881951,-0.09006211180124168,3.4565217391304337,0.8136645962732922,1.4596273291925468,3.925465838509318
2011,139,3207,65,3343,49,N,0,16,5,12,-7,1,16,-7,-3.304166666666667,-0.9375,-0.6666666666666661,3.4833333333333343,1.9166666666666679,2.7249999999999996,1.4875000000000007,-1.8666666666666636,-1.2375000000000007,2.4083333333333314,2.3249999999999993,-1.6708333333333338,3.5083333333333293
2011,139,3208,56,3292,41,N,0,15,6,11,-5,1,15,-5,-0.5333333333333314,4.274637681159419,-2.1728778467908905,-2.943995859213249,-0.7199792960662528,0.020186335403728606,2.9535196687370586,2.8214285714285694,-3.009834368530022,-3.320600414078676,0.30766045548654297,1.9326086956521733,-1.0952380952380985
2011,139,3257,81,3435,62,N,0,19,7,10,-3,1,19,-3,0.15657894736842337,2.1017543859649095,1.1280701754385971,3.9267543859649123,-2.9118421052631582,-3.758333333333333,-0.5447368421052623,-2.382894736842104,-0.20350877192982608,0.5697368421052644,5.462719298245615,-0.04956140350877192,-0.7491228070175424
2011,139,3268,70,3384,48,H,0,22,4,13,-9,1,22,-9,1.2467532467532507,1.3838226990400884,-2.562817617165443,-4.0478543195934495,2.7923489553924323,4.157538114059857,4.503246753246751,3.6780067758328627,0.41050254093732264,0.38876341050254126,-0.99209486166008,1.9758610954263132,1.7961603613777513
2011,139,3274,80,3205,62,N,0,18,3,14,-11,-1,-18,11,-2.949074074074076,-6.444444444444443,-1.0805555555555557,-4.632407407407406,-4.4712962962962965,-4.670370370370371,-1.3657407407407405,2.0601851851851833,1.3370370370370388,-0.8222222222222229,-3.2166666666666686,1.4703703703703699,0.5462962962962976
2011,139,3277,69,3320,66,N,0,3,4,13,-9,1,3,-9,0.9064102564102576,5.304558404558406,-1.363817663817664,0.12108262108262124,-4.255555555555555,-3.6982905982905976,6.474786324786324,0.049572649572645844,-1.7562678062678039,3.281054131054134,1.708974358974361,0.7391737891737886,-0.6162393162393158
2011,139,3328,86,3241,72,N,0,14,6,11,-5,-1,-14,5,-2.2023809523809526,2.461580086580085,-1.0154220779220768,-0.8906926406926416,-0.18317099567099504,1.3411796536796565,4.6366341991342,2.274080086580085,-2.196699134199136,-1.5054112554112535,-1.971049783549784,1.8065476190476195,-0.5365259740259738
2011,139,3345,53,3243,45,N,0,8,9,8,1,-1,-8,-1,0.3674242424242422,3.674999999999997,1.1573593073593074,5.381277056277057,-6.277380952380952,-5.7018398268398265,0.6994588744588768,-1.9213203463203428,-1.3826839826839823,-3.2285714285714295,-0.010389610389609949,-1.7794372294372298,0.05432900432900212
2011,139,3353,76,3256,51,N,0,25,7,10,-3,-1,-25,3,3.394755003450655,8.780193236714972,1.3574016563146998,3.7928743961352644,2.817374051069706,5.186507936507937,1.8241028295376136,2.622325741890961,1.266218081435472,-0.0755693581780541,1.466873706004141,-1.9010524499654933,1.8949275362318865
2011,139,3401,87,3270,47,N,0,40,2,15,-13,-1,-40,13,-4.006969696969698,-5.444242424242432,0.7303030303030305,4.409393939393938,-0.059696969696968694,-0.18090909090909335,-3.572727272727274,0.3160606060606099,-2.464545454545455,3.879090909090909,-0.5684848484848484,-2.0599999999999996,-0.05181818181817732
2011,139,3452,79,3222,73,A,0,6,9,8,1,-1,-6,-1,1.1499070977331876,9.5092530657748,0.6431252322556675,2.2327387588257164,2.1624674842066156,4.692586399108141,2.0769973987365304,4.397082868822,-0.6139725009290231,-1.3119472315124483,-0.6503716090672622,-0.6452062430323302,0.3593273875882588
2011,139,3453,59,3114,55,N,0,4,5,12,-7,-1,-4,7,-2.83724767080745,-5.284937888198755,-2.278726708074534,-3.7495147515527947,-4.125,-1.405182453416149,-2.134996118012422,-0.552503881987576,-4.169060559006212,-4.315217391304348,-6.7093361801242235,0.813761645962733,-2.0925854037267086
2011,139,3462,72,3355,56,H,0,16,2,15,-13,-1,-16,13,-0.6672289698605489,-5.931324036587192,2.960001499475184,2.487329434697857,2.137951716899085,1.0525940920677748,-5.610811216074373,-3.751536962063277,2.491752886489728,-0.5233543259859061,1.6233693207377415,-1.5970910181436495,4.438746438746438
2011,140,3177,75,3336,73,A,0,2,3,6,-3,1,2,-3,-1.8712121212121247,-1.5328282828282838,0.359427609427609,4.055555555555557,-2.051346801346801,-1.2575757575757578,-0.014309764309764716,-2.8686868686868685,3.635521885521886,-1.3375420875420865,0.5993265993265986,0.23821548821548877,-0.4175084175084187
2011,140,3181,71,3265,66,H,0,5,2,10,-8,1,5,-8,2.905172413793103,4.764367816091955,-0.8160919540229887,-3.632183908045974,1.166666666666666,3.112068965517242,5.692528735632184,-2.129310344827587,1.5775862068965516,5.379310344827585,2.88793103448276,-0.1637931034482758,3.166666666666668
2011,140,3211,89,3417,75,H,0,14,11,3,8,1,14,8,7.902065527065528,14.769943019943021,2.206908831908832,9.53311965811966,0.3447293447293447,-2.0274216524216513,2.674145299145298,2.7382478632478637,5.13710826210826,-2.838319088319089,-0.23753561253561273,1.018162393162393,2.3173076923076934
2011,140,3314,86,3246,74,N,0,12,5,4,1,-1,-12,-1,-4.804487179487182,-4.671474358974365,0.6570512820512815,1.628205128205126,2.815705128205126,3.5400641025641058,0.1314102564102555,-6.134615384615387,-5.429487179487179,-0.7243589743589709,0.02564102564102555,-2.833333333333333,0.8782051282051242
2011,140,3323,77,3396,64,N,0,13,2,10,-8,1,13,-8,2.943173674151936,1.2024904443382667,-3.1669851887243197,-8.735427615862399,5.193054228380316,5.781712852365025,2.566322264691829,0.09755733397037503,1.598751791686574,3.78057811753464,2.94320353559484,0.26015289058767355,0.25668896321069923
2011,140,3326,67,3210,60,H,0,7,4,5,-1,-1,-7,1,-1.5718081435472726,-1.6041062801932355,-0.8788474810213946,-3.1119047619047624,-3.3587646652864063,-1.8307453416149073,4.196342305037957,-3.582332643202207,-1.4240510697032462,6.680676328502415,4.335265700483093,-2.096859903381642,3.7090752242926186
2011,140,3390,75,3385,49,H,0,26,1,9,-8,-1,-26,8,-5.1744663382594425,-5.511822660098524,-4.370279146141215,-9.998768472906406,-0.17036124794745433,2.102873563218388,-0.4506568144499177,-4.127175697865354,-4.813711001642037,0.3214285714285694,1.632348111658457,0.05812807881773452,-3.3051724137931036
2011,140,3397,79,3266,70,H,0,9,1,8,-7,-1,-9,7,-1.2559607293127648,-12.31626928471249,-1.076788218793829,-3.2854137447405343,-0.35615357643758827,-1.504470546984571,-7.14147966339411,-7.017180925666203,5.746143057503508,0.9664270687237035,3.409449509116408,-1.2640252454417946,-4.142356241234221
2011,141,3124,82,3452,68,H,0,14,1,9,-8,1,14,-8,1.6661601994701591,1.3375409069658701,0.23133863175938973,-2.7000155836060475,2.2658173601371345,3.445067788686302,-1.3829281595761262,6.467430263362942,1.7888810970858646,-2.1801854449119524,-3.4966495247000156,3.0632304815334264,-4.142161446158639
2011,141,3163,64,3345,40,H,0,24,1,9,-8,1,24,-8,2.415340909090908,6.431249999999999,2.732954545454545,9.186931818181819,-2.8343749999999996,-1.976988636363636,1.3582386363636374,2.388352272727275,2.4957386363636367,-3.5968750000000007,0.0931818181818187,-1.316193181818182,-1.9315340909090928
2011,141,3207,79,3268,57,A,0,22,5,4,1,1,22,1,-3.1285714285714334,-2.5201863354037286,3.278726708074534,8.936490683229811,-4.621894409937887,-7.773447204968948,-3.5214285714285687,-5.605279503105589,-0.9832298136645967,-2.7114906832298153,1.373913043478261,-1.716770186335404,1.8333850931676992
2011,141,3208,61,3199,59,N,0,2,6,3,3,-1,-2,-3,1.7227743271221527,-0.047929606625260135,0.7691511387163565,-1.3417184265010356,5.881469979296067,6.299689440993788,-0.9473084886128369,1.1071428571428577,1.394927536231883,3.5690476190476197,-0.5871635610766042,-1.2059006211180119,3.225672877846794
2011,141,3257,85,3462,75,A,0,10,7,2,5,1,10,5,1.3361111111111121,0.024074074074071916,3.075925925925926,4.150925925925927,0.14351851851851904,-1.3731481481481502,-2.3925925925925924,-7.032407407407405,2.524074074074072,-0.704629629629629,4.897222222222222,-1.2620370370370368,5.109259259259257
2011,141,3328,88,3274,83,N,0,5,6,3,3,-1,-5,-3,-0.5330687830687815,3.12626262626263,-1.1533189033189029,-0.01899951899952157,1.663720538720538,4.321669071669074,2.350589225589225,-3.699795574795573,-1.0343314093314113,1.0501443001443,4.883116883116884,0.8082010582010586,-2.127465127465129
2011,141,3401,70,3353,48,N,0,22,2,7,-5,-1,-22,5,-4.504444444444445,-13.408888888888896,-0.00833333333333286,-1.3772222222222208,-2.9927777777777784,-3.3122222222222213,-6.369444444444445,1.1544444444444437,-1.3988888888888908,2.553333333333331,-1.5533333333333337,1.1205555555555557,-3.5366666666666653
2011,141,3453,65,3277,56,N,0,9,5,4,1,-1,-9,-1,-1.1237980769230766,4.248076923076923,-0.19807692307692282,4.297355769230769,-2.3249999999999993,0.1117788461538467,5.184855769230769,-0.11466346153846274,-6.337980769230768,-3.46153846153846,-4.260817307692307,2.0733173076923075,-2.2447115384615373
2011,145,3211,76,3257,69,N,0,7,11,7,4,1,7,4,5.821296296296296,12.19814814814815,-2.362962962962963,-2.5444444444444443,-0.5879629629629619,-2.4787037037037045,3.272222222222222,0.6805555555555571,3.276851851851852,-5.003703703703703,-0.7907407407407412,-0.08055555555555571,-0.5166666666666657
2011,145,3323,78,3328,53,N,0,25,2,6,-4,1,25,-4,1.4148351648351642,-0.939060939060937,-3.571511821511821,-9.835747585747587,1.7534132534132532,3.86888111888112,3.586496836496835,-0.9143356643356668,2.4628704628704625,2.1411088911088925,4.24117549117549,1.6126373626373631,-1.2157842157842182
2011,145,3390,72,3314,65,N,0,7,1,5,-4,-1,-7,4,-0.16462201591512127,5.685842175066313,-3.518401856763926,-3.933521220159152,0.8919098143236077,3.1919761273209524,2.6286472148541122,1.5872015915119384,-0.7616047745358081,2.3701923076923066,2.572778514588858,3.1724137931034484,-0.4917108753315631
2011,145,3397,85,3326,75,N,0,10,1,4,-3,-1,-10,3,1.3658474142345085,-8.01433691756273,-1.2370711725550434,-3.480030721966205,1.8335893497183822,0.5898617511520783,-8.15847414234511,-3.189196108550952,5.489759344598056,-2.272401433691755,0.35842293906809974,0.3458781362007173,-4.649257552483359
2011,146,3124,86,3453,76,H,0,10,1,5,-4,1,10,-4,-0.6113911290322562,-2.2620967741935516,-1.213709677419355,-4.88155241935484,2.9475806451612883,8.152721774193548,0.967237903225806,4.321068548387096,-3.82358870967742,-4.14516129032258,-6.622479838709677,6.281754032258064,-5.188508064516128
2011,146,3163,68,3207,63,N,0,5,1,5,-4,1,5,-4,2.231250000000003,-0.09375,1.0625,1.3187500000000014,1.765625,1.7593750000000004,-2.2531250000000007,4.840624999999999,2.1593750000000007,-2.2468749999999993,-2.5749999999999993,0.1656249999999999,-4.565624999999997
2011,146,3181,70,3177,63,N,0,7,2,3,-1,-1,-7,1,2.0929118773946342,-0.6417624521072796,1.6219667943805876,3.8582375478927204,0.6356960408684547,0.09291187739463425,-2.949872286079181,-0.07183908045977105,2.010217113665391,-0.6309067688378036,-0.9996807151979574,-0.7065772669220944,0.24872286079182615
2011,146,3401,79,3208,38,H,0,41,2,6,-4,-1,-41,4,-2.807619047619049,-5.065238095238101,0.24761904761904763,2.903333333333334,-3.494761904761905,-2.6614285714285693,-1.18809523809524,2.4957142857142856,-2.1052380952380965,1.9366666666666639,-1.2104761904761911,0.5185714285714287,-3.7866666666666653
2011,147,3323,73,3397,59,N,0,14,2,1,1,1,14,1,3.820365118752214,-5.52410492733074,-3.0481212336051047,-9.651276143211629,3.027118043247075,3.328872740163064,-2.8822226160935855,-5.444080113434957,6.190003544842256,2.4018964906061697,6.105370436015596,-0.02561148528890378,-0.2878411910669989
2011,147,3390,83,3211,60,N,0,23,1,11,-10,-1,-23,10,2.8480204342273296,8.6625159642401,-3.0951468710089403,-1.770593869731801,-1.6095146871008925,-2.2008301404853157,2.273946360153257,-3.1168582375478913,1.5774265644955285,-2.5787037037037024,2.628512132822477,0.7001915708812261,-0.4051724137931032
2011,148,3163,75,3181,40,N,0,35,1,2,-1,1,35,-1,1.1519396551724128,-2.763290229885058,2.3742816091954024,6.674209770114942,1.2670617816091951,0.3550646551724128,-3.9215158045977,4.235452586206897,2.221443965517242,-2.279633620689655,-3.254310344827587,-1.8205818965517242,-2.5400502873563227
2011,148,3401,58,3124,46,A,0,12,2,1,1,-1,-12,-1,-2.8745161290322585,-10.407096774193562,0.3612903225806452,-2.489677419354839,2.2325806451612884,5.047096774193548,-4.598387096774195,6.734193548387097,0.1351612903225785,2.324838709677419,-2.6393548387096777,4.2061290322580644,-5.402258064516126
2011,153,3323,72,3163,63,N,0,9,2,1,1,-1,-9,-1,-3.240728021978022,-2.722870879120876,4.050137362637363,12.00309065934066,-3.870364010989011,-5.433207417582416,-4.30477335164835,2.4153502747252773,0.02421016483516425,-4.360061813186814,-4.399725274725274,-1.4184409340659343,-3.006009615384613
2011,153,3401,63,3390,62,N,0,1,2,1,1,-1,-1,-1,1.3882758620689657,-4.2010344827586295,3.1655172413793107,5.004482758620691,-1.1934482758620693,-1.9262068965517223,-3.6017241379310363,4.632413793103449,2.2227586206896532,1.9699999999999989,-1.5475862068965522,-0.732413793103448,-1.7148275862068942
2011,155,3401,76,3323,70,N,0,6,2,2,0,-1,-6,0,1.2119780219780196,-4.140879120879134,-0.9126373626373625,-3.68934065934066,2.170989010989011,3.8275824175824162,-0.6983516483516503,2.4352747252747236,2.075164835164834,4.783186813186813,2.804725274725273,0.6240659340659347,-1.0046153846153842
2012,138,3116,72,3173,55,N,0,17,6,11,-5,1,17,-5,-2.657608695652172,-3.618988801054016,-0.5766633728590254,-1.753623188405797,-0.9165843214756251,0.5416666666666679,1.6479743083003946,-4.566534914361004,-2.841814888010539,-1.8261693017127811,1.866930171277998,-0.24505928853754932,-3.000247035573123
2012,138,3163,83,3341,47,H,0,36,1,16,-15,1,36,-15,4.275574712643678,0.5619805481874423,2.573054818744474,5.367771883289127,-1.9544208664898335,-3.202387267904511,0.24648541114058453,3.265097259062774,5.9997126436781585,-0.29398762157382663,0.1150530503978775,1.3708222811671087,-2.050353669319188
2012,138,3177,59,3140,55,N,0,4,7,10,-3,-1,-4,3,-2.442121212121208,-3.3812121212121227,-1.203939393939394,-2.713939393939391,0.6851515151515137,0.4827272727272742,-0.2618181818181817,3.81818181818182,2.0360606060606052,-0.5890909090909098,-0.8448484848484856,1.956363636363637,0.8578787878787892
2012,138,3211,86,3353,73,H,0,13,11,6,5,1,13,5,4.016544566544564,9.309706959706958,1.7344932844932845,2.9716117216117226,0.7844932844932853,0.6444444444444439,2.1763125763125757,-0.7950549450549431,2.330647130647133,-4.245054945054946,2.1158730158730155,-0.8376068376068377,-3.127594627594629
2012,138,3243,67,3343,64,N,0,3,8,9,-1,1,3,-1,-4.44542847503374,-6.010543184885293,0.24940958164642346,2.1617746288798934,-3.616649797570851,-4.499325236167344,-4.568910256410259,-1.4524291497975739,-0.18733130904183426,-2.0429318488528985,-2.847503373819162,-0.26518218623481804,-0.507169365721996
2012,138,3246,68,3270,62,N,0,6,2,15,-13,1,6,-13,4.299242424242429,4.272727272727273,-1.4659090909090908,-3.9943181818181834,1.1079545454545467,2.6571969696969724,0.9431818181818201,-3.7859848484848477,1.3731060606060606,5.282196969696969,4.696969696969697,1.7708333333333335,3.4621212121212146
2012,138,3257,67,3277,55,N,0,12,7,10,-3,1,12,-3,-0.7611111111111093,-0.5762626262626185,-0.10555555555555518,-0.19696969696969546,1.6651515151515142,1.4356060606060623,0.8755050505050512,-0.7161616161616138,-1.8686868686868685,2.235101010101012,-0.25202020202020314,1.3752525252525256,0.46212121212121104
2012,138,3268,59,3298,44,H,0,15,2,15,-13,1,15,-13,7.727483301012715,8.705882352941174,-3.1125834949364366,-8.487879767291531,6.926362852833442,7.105499892264596,3.6204212454212445,0.45130359836242206,3.066715147597499,1.7650829562594232,0.09432234432234399,2.348389355742297,3.9024725274725274
2012,138,3274,70,3226,41,N,0,29,3,14,-11,-1,-29,11,-6.513495200451722,-11.38884810841332,-1.650056465273856,-3.600169395821567,0.9565217391304337,0.7002258610954257,-5.28099943534726,1.3768492377188046,-2.446499153020893,-0.4341614906832305,-5.154234895539243,-0.6557029926595144,0.15959909655561688
2012,138,3345,83,3355,68,H,0,15,4,13,-9,1,15,-9,1.8777173913043477,7.2282608695652115,-2.451086956521739,-4.456521739130434,-0.4130434782608692,-1.8396739130434803,2.8315217391304337,-1.538043478260871,1.220108695652172,0.13315217391304301,1.241847826086956,2.6222826086956523,1.4048913043478244
2012,138,3376,80,3185,48,N,0,32,5,12,-7,-1,-32,7,2.4043423364075522,4.231966403162055,-1.422568072024594,-5.899127140974969,3.8333607817303452,2.3006148440931042,0.9038757136583229,1.5789690382081716,1.6715524813350893,3.221563460693897,4.084952788757136,-0.6145421607378125,1.1661451471234088
2012,138,3390,73,3214,51,N,0,22,1,16,-15,-1,-22,15,-5.6416129032258056,-1.7417741935483804,1.569193548387097,5.323548387096777,1.5748387096774188,2.8985483870967723,2.0875806451612906,-6.1240322580645135,-4.289354838709679,0.8451612903225794,4.118387096774194,0.0024193548387096975,2.820161290322581
2012,138,3397,72,3404,49,N,0,23,2,15,-13,1,23,-13,-0.26630434782608603,-2.8871047430830075,-4.2732213438735185,-10.86610671936759,1.7448122529644277,4.586215415019765,4.144762845849801,0.20281620553359403,-2.096096837944664,1.9869071146245059,-0.49431818181818166,1.9056324110671943,0.1758893280632421
2012,138,3401,69,3107,47,H,0,22,3,14,-11,-1,-22,11,-4.46161616161616,-4.784848484848489,1.4722222222222223,5.468181818181819,-0.32222222222222285,0.32979797979798064,-0.32676767676768037,0.25909090909090793,-2.3611111111111107,1.1010101010101003,2.0277777777777786,-1.4277777777777771,0.39090909090909065
2012,138,3452,68,3400,55,N,0,13,8,9,-1,-1,-13,1,3.373281308063916,6.685154217762914,0.7083797844667403,-1.028613898179115,-1.4557785209959135,-3.23002601263471,-1.3735600148643634,-0.4397993311036785,0.8970642883686377,-2.2075436640654047,0.9093273875882559,1.5873281308063918,-1.352935711631364
2012,138,3453,71,3235,57,A,0,14,7,10,-3,-1,-14,3,-2.788314176245212,-9.02250957854406,-2.1163793103448274,-5.586206896551722,2.454501915708814,1.4846743295019174,-1.0483716475095797,6.3180076628352495,-3.410440613026818,3.6628352490421463,-5.081896551724139,-0.06130268199233768,-7.260536398467433
2012,139,3124,81,3364,40,N,0,41,1,16,-15,1,41,-15,8.542959001782531,7.150445632798572,-0.5064171122994652,-2.636898395721925,8.697504456327987,12.148484848484848,3.668449197860962,5.60249554367201,7.074688057040998,-0.9543672014260238,3.7534759358288774,6.068805704099821,-2.233155080213903
2012,139,3143,84,3234,74,N,0,10,8,9,-1,1,10,-1,1.19122142477406,4.246776980329614,-3.300804093567252,-9.985812068048912,-0.6728136629452433,4.774986709197236,5.767577086656036,0.6963051568314746,-4.029970760233917,0.0803429027113225,0.6512161084529513,-1.2308612440191382,0.21172248803827642
2012,139,3174,73,3114,42,N,0,31,3,14,-11,-1,-31,11,-3.6083333333333343,-3.4499999999999957,-1.1916666666666664,-2.9000000000000004,-8.0,-5.191666666666666,-0.8666666666666654,2.400000000000002,-3.224999999999998,3.666666666666668,-0.20833333333333393,-1.0583333333333336,1.4916666666666671
2012,139,3181,82,3359,47,N,0,35,2,15,-13,1,35,-13,5.407575757575756,9.887499999999996,-2.7450757575757576,-8.062121212121212,1.7257575757575765,4.013257575757578,8.690151515151516,1.3246212121212153,0.7882575757575765,2.0492424242424256,4.297727272727273,3.666666666666666,1.6151515151515135
2012,139,3196,70,3326,65,N,0,5,9,8,1,1,5,1,-1.07236842105263,2.600877192982452,0.10745614035087847,1.9089912280701764,-2.495614035087719,-1.3640350877192944,4.904605263157897,1.014254385964911,-0.8640350877192979,3.003289473684209,0.6798245614035086,-1.2182017543859658,1.5197368421052637
2012,139,3207,61,3201,56,N,0,5,5,12,-7,-1,-5,7,6.475000000000001,4.1621753246753315,5.347240259740259,11.494480519480526,-3.178571428571429,-4.631168831168832,-2.745941558441558,0.3550324675324674,5.190746753246751,-0.3374999999999986,0.3183441558441551,-1.762337662337662,-2.6917207792207805
2012,139,3210,76,3357,50,N,0,26,4,13,-9,1,26,-9,2.2929761904761925,1.850357142857142,-2.272142857142857,-6.9371428571428595,4.649166666666668,7.73011904761905,2.4794047619047603,-1.2049999999999983,-0.29619047619047656,-0.26166666666666316,1.362619047619047,1.1330952380952386,2.209047619047622
2012,139,3242,57,3304,49,N,0,8,11,6,5,1,8,5,3.4791666666666643,-3.1597222222222143,-3.159722222222223,-12.819444444444446,-5.208333333333332,-6.423611111111111,-3.5902777777777786,-0.7013888888888857,1.8819444444444464,-0.006944444444444642,-0.5347222222222214,1.041666666666667,-0.9236111111111107
2012,139,3261,64,3361,56,N,0,8,5,12,-7,1,8,-7,-1.0024242424242473,-9.18363636363636,-0.5448484848484845,-4.1084848484848475,1.702727272727273,2.505454545454544,-3.5500000000000007,1.5942424242424238,3.003636363636362,3.9336363636363636,-0.3151515151515145,-0.39454545454545453,-2.2445454545454524
2012,139,3265,76,3208,70,N,0,6,13,4,9,-1,-6,-9,3.3646428571428544,4.652499999999996,-2.459761904761905,-8.039761904761905,0.12916666666666643,2.1657142857142855,4.643928571428571,-2.604999999999997,-1.845357142857143,0.1626190476190459,0.43880952380952465,-2.3604761904761906,3.395595238095236
2012,139,3323,74,3251,43,N,0,31,1,16,-15,-1,-31,15,-2.822619047619046,-3.9125000000000085,-0.6577380952380949,0.0994047619047631,-1.979166666666666,-0.8720238095238066,3.392261904761906,4.80952380952381,-2.55952380952381,5.382142857142856,-3.6416666666666657,0.3809523809523814,-3.6136904761904756
2012,139,3328,88,3276,67,N,0,21,6,11,-5,-1,-21,5,-1.2416666666666636,-2.049999999999997,0.33333333333333304,2.491666666666667,-3.825000000000001,-5.68333333333333,-1.875,-4.650000000000002,-0.5833333333333339,-4.283333333333335,1.083333333333334,-0.8583333333333334,-5.699999999999999
2012,139,3336,85,3431,77,N,0,8,4,13,-9,1,8,-9,5.278985507246379,9.033233383308335,0.4763868065967012,-1.304972513743131,3.445402298850574,2.3965517241379324,0.48700649675162566,-1.360694652673665,-0.8427036481759114,-1.2321339330334826,0.47538730634682835,-1.1867816091954015,3.6762868565717106
2012,139,3382,72,3195,65,N,1,7,5,12,-7,-1,-7,7,3.971059113300491,5.312602627257803,3.7307060755336625,11.85673234811166,-2.862068965517242,-2.1855500821018037,2.6496305418719217,-3.5595238095238066,6.139778325123153,3.418924466338261,3.751231527093595,0.8321018062397374,3.806650246305418
2012,139,3385,69,3166,67,N,0,2,3,14,-11,-1,-2,11,-0.8270202020202007,-0.8694444444444471,3.7222222222222223,10.889141414141415,-3.036363636363637,-4.5449494949494955,-2.0608585858585844,1.214141414141416,1.6234848484848499,0.8345959595959584,-0.39318181818181763,-0.7234848484848477,0.6739898989899
2012,139,3435,60,3292,46,N,0,14,7,10,-3,-1,-14,3,-2.26200466200466,2.134615384615387,1.3986790986790982,6.3463869463869464,-3.267637917637918,-1.3394716394716397,1.5366355866355867,-1.0532634032634043,-0.7302641802641787,-0.7084304584304597,0.8167832167832172,-1.039083139083139,-1.229370629370628
2012,140,3163,72,3243,26,N,0,46,1,8,-7,1,46,-7,4.9418365210107495,0.8331006561496537,2.027170878123691,1.675869049281026,1.1619084182605057,0.786681558006423,0.9618700265251992,3.3188084601423995,5.157877286053328,1.9172134580483053,1.975376937037554,1.3513890827865422,-1.8800432779561635
2012,140,3211,65,3274,54,N,0,11,11,3,8,1,11,8,-0.01354515050167393,-1.4546822742474887,-1.9245819397993307,-7.119899665551838,-2.505016722408028,-3.0478260869565226,-2.714715719063543,-2.028595317725749,0.19331103678929829,-5.322073578595319,-1.2782608695652176,-0.3327759197324416,-1.6133779264214034
2012,140,3246,65,3453,62,N,0,3,2,7,-5,1,3,-5,2.475574712643681,2.7413793103448256,-3.8663793103448274,-10.81537356321839,2.6142241379310356,3.5610632183908066,4.5071839080459775,-2.0639367816091934,-5.917385057471263,6.114224137931036,1.2931034482758612,0.5150862068965516,-0.1494252873563191
2012,140,3268,72,3257,68,N,0,4,2,7,-5,-1,-4,5,-4.908730158730158,-2.512626262626256,2.4563492063492065,7.877705627705627,-1.255411255411257,-0.10443722943722733,0.04022366522366738,-1.978715728715727,-4.2772366522366525,2.3207070707070727,2.652958152958152,-0.47420634920634885,1.9215367965367953
2012,140,3376,72,3345,61,N,0,11,5,4,1,-1,-11,-1,1.342089371980677,2.546195652173907,-0.6542874396135265,-2.805253623188406,3.275060386473429,0.702294685990335,-2.9064009661835755,4.066123188405797,3.3185386473429936,2.090881642512077,0.8517512077294684,1.0561594202898554,2.8635265700483075
2012,140,3390,72,3452,55,N,0,17,1,8,-7,1,17,-7,4.871902758298273,7.4977403771232645,0.513246065139473,-1.089683652797257,-2.9901044101605123,-6.705625681782765,-2.02306373694873,4.761882499610412,2.286504597163786,-4.4809100825931125,-3.352734922861151,-1.013168147109241,-2.7224559763129186
2012,140,3397,63,3177,48,N,0,15,2,7,-5,-1,-15,5,-0.2170454545454561,0.5829545454545482,2.273863636363637,7.085227272727273,-3.9749999999999996,-6.743181818181821,-3.422727272727272,-1.6704545454545467,1.3125,1.9102272727272727,1.450000000000001,-1.0659090909090914,0.4375
2012,140,3401,61,3116,59,N,0,2,3,6,-3,-1,-2,3,-3.4022727272727273,-2.964772727272731,1.7784090909090908,8.4,-1.2079545454545446,-2.3886363636363654,-0.4852272727272755,-1.081818181818182,-1.8579545454545432,-0.2556818181818201,0.6363636363636367,-0.6727272727272724,-2.2170454545454543
2012,141,3124,76,3196,57,N,0,19,1,9,-8,1,19,-8,4.54964114832536,-1.7107256778309434,-1.6339712918660294,-7.009370015948964,4.677432216905903,4.795853269537478,-2.8648325358851707,6.40809409888357,5.3867623604465695,-3.7892743221690584,-0.31997607655502414,3.6367623604465713,-4.080342902711324
2012,141,3181,96,3435,80,N,0,16,2,7,-5,1,16,-5,1.3969696969696983,5.712499999999999,-0.826641414141414,-2.9068181818181813,-1.520202020202019,-0.5718434343434318,2.6353535353535342,0.9912878787878796,-0.19532828282828163,-0.10202020202020279,3.784090909090909,2.2487373737373733,-0.8325757575757571
2012,141,3210,76,3207,64,N,0,12,4,5,-1,-1,-12,1,-5.770833333333336,0.19318181818181301,1.267045454545455,6.5340909090909065,-1.2291666666666679,-0.850378787878789,0.9393939393939412,0.5056818181818201,-3.5359848484848477,-1.0208333333333357,-0.3731060606060588,-0.45075757575757613,1.990530303030301
2012,141,3242,70,3174,64,N,0,6,11,3,8,-1,-6,-8,-1.0166666666666657,-1.6194444444444471,0.5638888888888891,2.0444444444444443,8.566666666666666,6.877777777777776,1.0444444444444443,-0.5861111111111121,-0.6944444444444464,-2.2055555555555557,-1.1527777777777768,0.18333333333333357,0.9444444444444429
2012,141,3323,73,3143,62,N,0,11,1,8,-7,-1,-11,7,-0.5736111111111093,2.4486111111111057,-0.9236111111111107,-1.5236111111111104,-3.1736111111111107,0.02777777777778212,4.168055555555558,3.3888888888888893,-2.4861111111111125,0.2749999999999986,-3.995833333333332,-1.083333333333333,-2.4499999999999993
2012,141,3336,90,3261,80,N,0,10,4,5,-1,-1,-10,1,-4.404743083003954,-13.052042160737798,-1.4457180500658757,-3.6383399209486154,-1.8106060606060588,-1.937878787878791,-1.292753623188407,-2.1185111989459813,1.3005928853754938,4.957839262187088,-1.0100790513834,0.21212121212121104,-2.2371541501976253
2012,141,3382,66,3265,63,N,0,3,5,13,-8,-1,-3,8,1.9189162561576367,2.8833169129720844,1.4821346469622334,6.723875205254515,-2.476354679802956,-3.351264367816091,-0.6639408866995069,0.24190476190476318,5.226206896551725,1.8396387520525472,3.8540886699507384,2.7163875205254517,0.3366502463054193
2012,141,3385,74,3328,70,N,0,4,3,6,-3,-1,-4,3,1.7146464646464636,2.313888888888883,3.488888888888889,8.814141414141416,1.913636363636364,1.3717171717171688,-0.6691919191919187,4.347474747474749,2.548484848484849,2.7345959595959606,-1.4765151515151516,-0.05681818181818166,3.6989898989899004
2012,145,3124,83,3210,68,N,0,15,1,4,-3,1,15,-3,3.9981060606060588,-0.5056818181818201,-0.10984848484848486,-1.121212121212121,2.9526515151515156,3.452651515151512,-0.5435606060606055,8.443181818181817,4.272727272727272,-3.6401515151515174,-2.390151515151514,4.3977272727272725,-4.643939393939396
2012,145,3181,74,3385,47,N,0,27,2,3,-1,1,27,-1,3.6646464646464665,4.351388888888884,1.8930555555555557,3.6891414141414156,-0.7196969696969688,-0.3824494949494941,2.014141414141415,2.026641414141416,2.519318181818182,3.05959595959596,2.8068181818181817,2.0265151515151514,1.6573232323232325
2012,145,3390,76,3376,60,N,0,16,1,5,-4,-1,-16,4,-4.23663705781518,-4.618513323983166,-0.28619292504285454,2.1210846189808326,-1.0751129811438354,2.5292971793673065,3.180068567866604,-10.10004675081814,-4.7840891382265855,0.7417796478105032,3.014570671653421,0.36582515194015874,-0.6857565840735553
2012,145,3397,84,3242,73,N,0,11,2,11,-9,-1,-11,9,0.3541666666666643,-1.4854797979797922,-1.4172979797979801,-4.503156565656564,-4.5265151515151505,-6.7815656565656575,-4.232323232323232,-1.199494949494948,0.36300505050505194,0.27335858585858475,0.4179292929292924,-0.32954545454545503,-0.21906565656565746
2012,146,3163,77,3336,59,N,0,18,1,4,-3,1,18,-3,-0.3034107946026978,-7.6366816591704065,2.3698775612193907,5.4227886056971535,-4.850574712643677,-6.712643678160921,-1.9539605197401304,-0.7930409795102449,5.7033358320839564,2.197651174412796,0.7329460269865056,0.0028735632183902737,-4.0239880059969995
2012,146,3246,79,3211,62,N,0,17,2,11,-9,-1,-17,9,0.1455128205128169,0.11923076923076792,-0.8865384615384615,-3.751602564102562,-2.0240384615384617,-4.154166666666669,-2.0955128205128215,5.190064102564104,2.60544871794872,-5.093269230769231,-1.9000000000000004,0.19711538461538458,-6.064102564102566
2012,146,3268,81,3401,74,N,0,7,2,3,-1,1,7,-1,3.52034632034632,-0.6863636363636374,0.23809523809523814,0.757142857142858,1.7841991341991346,-0.7576839826839858,-1.412445887445891,4.758008658008656,2.408549783549784,1.1212121212121176,-2.195887445887446,0.326731601731602,-2.3185064935064936
2012,146,3323,79,3382,35,N,0,44,1,5,-4,1,44,-4,6.460344827586205,8.763793103448279,-0.7931034482758621,-2.7218390804597714,3.97126436781609,5.362068965517242,4.510344827586206,-1.9166666666666643,5.752873563218392,3.620114942528737,6.232183908045976,2.701149425287356,6.113793103448275
2012,147,3124,77,3397,58,N,0,19,1,2,-1,1,19,-1,3.3314393939393945,-0.5397727272727266,-1.6382575757575757,-4.513257575757574,1.488636363636365,1.428030303030301,-1.2272727272727266,5.71590909090909,4.774621212121211,-1.8806818181818183,1.5,3.3598484848484844,-2.6685606060606073
2012,147,3390,81,3181,69,N,0,12,1,2,-1,-1,-12,1,0.4150537634408593,-1.6342741935483858,-0.5549731182795696,-2.9481182795698917,0.5215053763440878,2.7227150537634426,1.2559139784946236,-6.0998655913978475,-1.1651881720430115,3.3284946236559136,6.423387096774194,2.7190860215053756,-0.09650537634408707
2012,148,3163,80,3246,65,N,0,15,1,2,-1,1,15,-1,0.1839080459770095,-7.948275862068968,1.6724137931034484,1.858477011494255,-2.829741379310345,-5.733477011494253,-5.002873563218392,7.887212643678158,5.8872126436781596,-1.4590517241379288,-2.038793103448276,0.8987068965517242,-7.324712643678163
2012,148,3323,80,3268,49,N,0,31,1,2,-1,-1,-31,1,2.147619047619049,-0.18333333333333712,-1.095238095238095,-2.492857142857142,-2.6309523809523796,-4.3273809523809526,0.6511904761904752,2.7261904761904745,1.1964285714285694,0.23333333333333073,-5.326190476190475,0.2797619047619051,-3.682142857142857
2012,153,3124,59,3390,47,N,0,12,1,1,0,1,12,0,3.4423264907135867,-2.4149560117302045,-1.2106549364613879,-3.927663734115347,5.036656891495603,8.042033235581622,1.0498533724340167,-0.31085043988269945,4.02003910068426,-0.5366568914956016,3.8665689149560123,4.616813294232649,-3.4154447702834805
2012,153,3323,83,3163,75,N,1,8,1,1,0,-1,-8,0,-0.007758620689653384,-3.631609195402305,2.7140804597701154,6.5293103448275875,-6.600574712643677,-8.712643678160918,-1.6612068965517235,2.3663793103448256,2.6997126436781578,0.4201149425287376,-1.8054597701149415,-0.24712643678160884,-4.691379310344827
2012,155,3124,80,3323,61,N,0,19,1,1,0,1,19,0,3.243939393939396,-1.0015151515151572,-0.8181818181818179,-2.2212121212121207,-0.6515151515151487,0.015151515151515582,0.5272727272727273,7.068181818181817,4.27272727272727,-2.3651515151515152,-2.9484848484848474,3.6060606060606064,-6.26060606060606
2013,138,3143,90,3201,76,N,0,14,2,15,-13,1,14,-13,-0.45380434782608603,0.5119047619047592,-2.659420289855073,-6.205874741200827,4.12021221532091,7.2228260869565215,3.779373706004142,2.6473861283643885,-3.0895445134575574,0.3403209109730856,-2.9183488612836435,0.5282091097308488,3.2056159420289845
2013,138,3163,105,3225,37,H,0,68,1,16,-15,1,68,-15,6.746264367816092,2.363577586206887,-1.1015086206896552,-4.228879310344826,-0.25632183908046,-1.94346264367816,0.7390086206896544,-0.2861350574712631,6.29073275862069,0.5741379310344854,4.168534482758621,1.9552442528735634,0.5555316091954019
2013,138,3166,61,3393,56,N,0,5,10,7,3,1,5,3,-3.1352813852813846,-7.1739718614718555,2.769751082251082,5.733495670995673,-3.7808441558441572,-6.187770562770563,-6.462121212121211,-1.5367965367965368,0.25974025974026027,-0.6563852813852797,-3.8966450216450212,-1.206439393939394,2.0779220779220786
2013,138,3208,70,3285,50,N,0,20,4,13,-9,1,20,-9,1.0768944099378857,2.3018633540372733,-1.4530434782608692,-1.9093167701863365,0.4993788819875764,1.3925465838509297,2.3146583850931712,-0.78745341614907,-2.2118012422360227,1.330310559006211,0.36422360248447205,-1.7829813664596275,1.6636024844720474
2013,138,3235,72,3211,60,N,0,12,5,12,-7,-1,-12,7,2.8448470209339796,9.729991948470207,-2.4955314009661835,-8.006944444444445,-4.6406199677938815,-2.0818840579710134,4.481763285024154,-2.645571658615136,-0.9230475040257637,-3.954106280193237,3.9704710144927526,1.1135064412238327,-0.7450684380032193
2013,138,3242,67,3160,52,A,0,15,12,5,7,-1,-15,-7,-3.3456108597285095,0.30778280542986636,-1.1436048265460022,-2.4286425339366495,-1.5058974358974364,-1.805550527903467,2.5260482654600285,-0.3980995475113147,-4.016561085972853,-0.2990950226244333,1.1912368024132718,0.0012518853695322463,1.6455052790346905
2013,138,3268,72,3346,52,H,0,20,4,13,-9,1,20,-9,2.2726190476190453,0.34464285714285836,-2.8125,-5.55238095238095,2.3291666666666657,-1.0535714285714306,4.637499999999999,1.807142857142857,-0.08749999999999858,-0.7815476190476218,-6.710119047619047,-0.5160714285714283,-1.8922619047619058
2013,138,3277,55,3265,47,N,0,8,5,12,-7,-1,-8,7,-2.3541666666666643,-6.410256410256416,0.9599358974358969,5.839743589743588,2.689102564102562,1.91826923076923,-3.972756410256409,-3.2067307692307665,1.3173076923076934,2.1346153846153832,1.584935897435896,-0.4423076923076925,-0.8285256410256387
2013,138,3304,73,3151,59,N,0,14,6,11,-5,-1,-14,5,-0.5344515242378804,1.2561219390304856,0.7554660169915044,4.721576711644175,-2.0921726636681672,-0.16691654172913317,1.4295977011494259,-1.8168728135932035,-0.9528360819590205,-0.6836269365317342,2.386525487256373,-1.069215392303848,1.61434907546227
2013,138,3328,78,3141,73,N,0,5,6,11,-5,-1,-5,5,2.126623376623378,4.992207792207786,-0.6751082251082252,1.3865800865800892,-1.927056277056277,-1.8666666666666671,3.086147186147185,-0.889393939393937,-0.5344155844155836,0.5783549783549766,5.120129870129871,0.8103896103896098,-1.2919913419913414
2013,138,3376,74,3355,52,N,0,22,4,13,-9,-1,-22,9,0.4149068322981364,-3.5724223602484386,2.4024844720496894,4.459999999999999,2.742608695652173,-0.7557763975155325,-4.888198757763977,1.1806211180124215,3.6265838509316772,4.474285714285715,0.5621118012422368,-0.7101863354037268,1.323354037267082
2013,138,3378,71,3403,70,A,0,1,10,7,3,1,1,3,2.2714285714285722,9.135714285714293,1.0833333333333321,3.0261904761904788,-0.9547619047619023,-1.1642857142857146,3.1690476190476176,5.316666666666666,2.8357142857142854,1.4904761904761905,0.28809523809523796,2.65952380952381,2.1023809523809547
2013,138,3397,83,3331,62,H,0,21,2,15,-13,-1,-21,13,-1.4532563025210088,-4.790091036414566,1.4677871148459385,2.3280812324929965,-3.0919117647058822,-3.461309523809522,-3.4457282913165272,-4.3235294117647065,0.8370098039215694,-0.9628851540616239,1.5140056022408963,0.26488095238095255,1.5075280112044815
2013,138,3401,71,3455,45,H,0,26,3,14,-11,1,26,-11,4.458333333333332,7.243055555555557,-0.10416666666666607,-1.5486111111111107,-0.5902777777777768,-0.8125,2.027777777777777,3.944444444444443,4.784722222222221,1.4166666666666679,0.11111111111111072,-0.9444444444444446,-1.722222222222225
2013,138,3417,66,3391,49,N,0,17,3,14,-11,-1,-17,11,0.15256211180124168,-2.3209472049689452,3.489099378881988,9.543121118012419,-1.9054347826086957,-3.190403726708075,-4.166537267080745,-1.7871583850931678,-2.9168012422360228,-3.5792080745341615,-1.527717391304348,1.0172049689440996,-1.8391925465838526
2013,138,3435,60,3386,54,N,0,6,8,9,-1,-1,-6,1,0.5141304347826079,4.34347826086956,0.1010869565217396,1.5342391304347807,-1.8418478260869584,-2.477173913043478,0.4434782608695649,-0.820652173913043,0.0625,-3.3842391304347785,0.7978260869565208,0.006521739130434412,0.6119565217391312
2013,139,3124,82,3341,40,H,0,42,1,16,-15,1,42,-15,7.91325562483058,6.551233396584436,-0.9213201409596095,-0.4545269720791545,0.9633369476822988,0.6347926267281103,-1.111005692599619,1.8298997018162098,4.100975874220657,-8.659934941718623,-2.34209812957441,1.392111683383031,-5.245866088370834
2013,139,3173,96,3385,90,A,2,6,7,10,-3,1,6,-3,0.6898148148148167,1.537037037037038,2.3055555555555554,8.342592592592592,-1.2592592592592595,-2.222222222222225,-0.9212962962962976,2.4953703703703702,0.9120370370370363,3.5324074074074083,-0.3009259259259256,-2.3703703703703702,1.921296296296294
2013,139,3174,66,3452,53,H,0,13,6,11,-5,1,13,-5,-1.2858220211161395,-5.107390648567119,-1.2701357466063348,-5.124057315233786,0.41485671191553486,-0.4704374057315235,-2.0703619909502287,2.5689291101055822,-0.21523378582202213,-1.7575414781297134,-3.8361236802413288,0.5088989441930618,-6.829185520361989
2013,139,3181,67,3214,51,H,0,16,2,15,-13,1,16,-13,4.579182630906768,-1.3846104725415032,0.7450830140485314,-3.298275862068964,-1.321839080459771,-3.5640485312899095,-3.7318007662835235,2.0732439335887562,2.748914431673054,1.4939974457215826,-1.5686462324393347,0.302873563218391,-2.284865900383142
2013,139,3199,60,3343,44,N,0,16,8,9,-1,1,16,-1,2.1857864357864365,-0.06854256854256846,-0.9725829725829724,-5.226190476190478,2.3777056277056285,2.311688311688311,-1.9531024531024528,-3.383116883116884,-0.2781385281385269,1.211760461760461,0.26118326118325896,0.23520923520923542,-1.1406926406926399
2013,139,3234,69,3274,53,H,0,16,9,8,1,1,16,1,1.4488095238095227,-2.238095238095241,1.9273809523809522,2.932142857142857,-1.6154761904761905,-3.6261904761904766,-4.171428571428574,-0.6500000000000021,2.852380952380953,-3.010714285714286,-1.2095238095238106,1.4988095238095234,-0.9916666666666636
2013,139,3246,61,3298,41,N,0,20,2,15,-13,1,20,-13,6.027717652717655,12.073051948051948,-0.7662337662337659,-1.9900793650793638,3.9902597402597397,3.3989297739297744,3.8626142376142347,-2.1753246753246778,-0.5708273208273216,1.3263588263588257,3.3606902356902353,3.7193963443963445,5.470779220779217
2013,139,3257,74,3292,49,H,0,25,5,12,-7,1,25,-7,1.5515476190476214,-0.8776190476190422,-0.023809523809523725,-0.8211904761904805,0.6600000000000001,1.2955952380952347,-1.5165476190476177,-0.8189285714285717,1.149166666666666,0.4072619047619028,2.146190476190476,0.7640476190476191,-0.8051190476190477
2013,139,3261,75,3453,71,H,0,4,6,11,-5,1,4,-5,0.3687628161312375,1.910970608339035,-3.9146445659603555,-9.876025290498973,2.7857142857142847,2.3213431305536574,4.62799043062201,0.2576896787423131,-2.512474367737525,3.792464114832537,-0.6830997949419011,3.1228639781271355,2.0559637730690365
2013,139,3276,60,3437,52,N,0,8,8,9,-1,1,8,-1,0.5547619047619037,-2.990476190476187,-2.076190476190477,-6.583333333333336,1.609523809523811,1.3857142857142861,1.18809523809524,-0.3857142857142897,-2.147619047619047,2.980952380952381,-1.0238095238095237,-0.592857142857143,-3.033333333333333
2013,139,3314,59,3107,54,N,0,5,3,14,-11,-1,-5,11,-1.0482804232804206,-5.376322751322746,0.80489417989418,0.12896825396825307,-6.730820105820106,-9.884920634920636,-3.19246031746032,1.1865079365079367,0.7989417989417973,-3.922619047619051,-1.374338624338625,-1.6732804232804233,-4.103174603174601
2013,139,3323,97,3404,64,N,0,33,1,16,-15,1,33,-15,1.6922750424448196,4.982112539413052,-4.815971380063061,-12.685847683725441,0.3669658016007755,0.8565365025466889,4.775406257579432,-0.05517826825127159,3.2308391947610993,1.453674508852778,1.3590225563909772,-0.31530439000727606,-0.2562454523405293
2013,139,3329,73,3177,56,N,0,17,7,10,-3,-1,-17,3,-1.4950216450216445,1.1309523809523725,2.312770562770562,9.350432900432903,-1.6294372294372312,-0.45454545454545503,-0.5859307359307362,-0.654112554112551,0.7679653679653686,1.4441558441558442,-1.8320346320346328,-0.3707792207792213,-0.5707792207792188
2013,139,3336,85,3142,55,N,0,30,3,14,-11,-1,-30,11,-0.22714285714285865,-1.3347619047619048,-0.4209523809523805,1.5166666666666657,-1.5723809523809518,-0.5061904761904792,-0.5285714285714285,1.5161904761904736,4.455238095238096,0.5080952380952404,-2.569523809523808,-0.5823809523809524,-2.8100000000000023
2013,139,3345,77,3251,43,N,0,34,4,13,-9,-1,-34,9,-0.21999999999999886,1.0416666666666714,-0.5150000000000006,-0.05833333333333357,2.210000000000001,3.785,5.335833333333333,3.0950000000000024,-2.0525,3.0416666666666643,0.8799999999999999,0.29583333333333295,1.8575000000000017
2013,139,3390,72,3409,56,H,0,16,1,16,-15,1,16,-15,-0.7862903225806477,-0.11491935483870463,-1.1995967741935485,-0.76008064516129,-1.096774193548388,-2.5887096774193523,1.6552419354838719,1.82358870967742,-2.487903225806452,-3.050403225806452,-4.806451612903226,1.1965725806451615,-1.221774193548388
2013,140,3143,82,3378,78,N,1,4,2,10,-8,1,4,-8,-0.37619047619047663,-3.507142857142867,-2.105952380952381,-3.6559523809523817,0.8095238095238084,2.597619047619048,1.3238095238095262,-2.919047619047621,-1.8023809523809522,-1.0464285714285708,-1.0880952380952387,-2.0630952380952383,-2.948809523809526
2013,140,3163,77,3435,44,H,0,33,1,8,-7,1,33,-7,6.662931034482757,8.144827586206887,2.2922413793103456,6.833620689655174,-2.539655172413795,-4.066379310344827,1.2577586206896534,3.478448275862071,5.03448275862069,-0.07586206896551317,3.0060344827586203,3.0198275862068966,-0.996551724137932
2013,140,3208,65,3235,60,N,0,5,4,5,-1,1,5,-1,1.895217391304346,10.333695652173915,-3.4910869565217393,-7.462499999999999,-1.3554347826086968,1.3847826086956516,5.630652173913045,-2.2626086956521725,-2.771195652173912,-3.6852173913043487,2.943804347826087,0.39054347826086966,1.6764130434782594
2013,140,3242,75,3376,69,N,0,6,12,4,8,1,6,8,4.109089120598071,1.5855091200359794,1.7427559652623588,2.2272139625080793,0.40898232202579976,-3.5635592029453953,-4.4337708327478165,1.4901492369523055,6.031716365475958,2.270523594053005,-0.34674404879008414,0.4718951125600741,1.2411820915657241
2013,140,3268,74,3277,49,H,0,25,4,5,-1,1,25,-1,3.6517857142857153,1.3779761904761898,-0.8333333333333339,-3.1190476190476204,2.520833333333332,3.1339285714285694,2.541666666666668,0.7529761904761934,3.604166666666668,3.9017857142857117,-0.7559523809523814,0.5505952380952381,1.3035714285714306
2013,140,3304,74,3401,63,A,0,11,6,3,3,1,11,3,-2.746678743961354,0.22041062801932298,3.1437198067632846,11.213768115942027,1.1434178743961354,0.13315217391304301,0.46527777777777857,-0.3746980676328491,-1.3529589371980677,-0.6228864734299524,-1.628623188405797,-0.4571256038647342,-0.9936594202898537
2013,140,3328,85,3417,72,N,0,13,6,3,3,1,13,3,0.2629870129870113,0.04649350649350481,4.9089610389610385,12.228051948051945,1.1590909090909083,0.7719480519480513,-3.38051948051948,2.0287012987012965,-1.6520779220779218,-2.315324675324675,-4.331818181818182,1.0355844155844163,-0.1866233766233769
2013,140,3397,68,3166,52,H,0,16,2,10,-8,-1,-16,8,-4.199404761904763,-6.839285714285708,3.9732142857142856,10.949404761904765,-5.9375,-7.616071428571427,-5.232142857142858,-3.5773809523809526,3.1101190476190492,-1.3214285714285694,-0.17857142857142883,0.11309523809523858,0.26488095238095255
2013,141,3124,85,3199,47,H,0,38,1,8,-7,1,38,-7,2.977214541730671,0.4219150025601621,-1.0924219150025598,0.2772657450076821,-1.9869431643625202,-1.9485407066052218,-2.7898105478750637,0.6436251920122871,2.0491551459293404,-8.352278545826932,-2.1707629288274433,0.2931387608806961,-3.119815668202765
2013,141,3174,78,3314,69,H,0,9,6,3,3,1,9,3,-2.029761904761905,-7.5726190476190425,0.5678571428571426,-1.8988095238095237,-3.4178571428571445,-6.407142857142858,-3.6869047619047635,1.197619047619046,-0.13809523809523938,-5.6726190476190474,-6.342857142857143,-1.1880952380952379,-5.7976190476190474
2013,141,3181,68,3329,59,H,0,9,2,7,-5,1,9,-5,-1.2999178981937618,-4.268472906403936,0.3009031198686367,-0.867323481116582,-1.4599343185550087,-0.4412972085385878,-3.0659277504105074,1.1647783251231516,-1.2198686371100163,2.1500821018062375,-1.3744663382594418,0.7338259441707713,-0.550738916256158
2013,141,3246,84,3173,70,N,0,14,2,7,-5,-1,-14,5,-4.106481481481481,-7.949074074074076,-1.3055555555555554,-1.7268518518518512,-0.2592592592592595,-0.22685185185185475,-3.9305555555555536,5.314814814814817,0.2222222222222232,1.2314814814814827,-3.8472222222222223,-2.476851851851852,-1.481481481481481
2013,141,3257,76,3345,63,H,0,13,5,4,1,1,13,1,2.1458333333333357,4.458333333333343,0.20833333333333393,3.1666666666666643,0.08333333333333393,1.7291666666666643,1.7916666666666679,-0.7291666666666643,-1.6666666666666679,-0.06250000000000355,3.749999999999999,0.10416666666666607,0.8333333333333357
2013,141,3261,71,3336,66,H,0,5,6,3,3,1,5,3,-0.37980861244019337,-3.5761722488038217,-2.165358851674641,-1.8153110047846894,1.9800000000000004,3.2520574162679416,-0.6220095693779903,0.054832535885168454,2.3403827751196182,0.7874641148325381,-2.060956937799043,1.1214354066985641,-2.757607655502394
2013,141,3323,74,3234,57,A,0,17,1,9,-8,-1,-17,8,-2.883064516129032,-8.813440860215053,1.7776881720430113,3.9991935483870975,-0.4368279569892479,-0.7021505376344095,-3.453225806451613,1.9376344086021504,-2.1779569892473134,1.7706989247311817,-2.466666666666667,1.4733870967741933,0.9895161290322587
2013,141,3390,73,3276,40,H,0,33,1,8,-7,-1,-33,7,0.48509984639017034,-5.48448540706606,2.1870967741935483,3.2987711213517645,-3.6365591397849446,-5.8136712749615995,-3.4248847926267274,-4.714362519201231,3.7057603686635954,0.4629032258064516,1.5850230414746544,-0.4212749615975424,-4.59132104454685
2013,145,3143,73,3261,63,N,0,10,2,6,-4,1,10,-4,-1.190191387559807,3.2080770107085854,1.1170255183413071,4.316501480975166,-0.7738095238095237,0.5179425837320579,3.9910571884256107,-0.8886420596946962,-2.5351446798815225,-2.316273638642061,0.29619503303713834,-2.1645306447938024,-1.2940590111642756
2013,145,3163,76,3268,50,H,0,26,1,4,-3,1,26,-3,3.2569786535303784,2.9251847290640285,2.829741379310345,7.544334975369459,-1.2521551724137936,-2.937807881773397,-2.329741379310345,1.8713054187192135,3.4719827586206904,-0.8443144499178956,3.0411535303776684,2.7942323481116587,-0.9709564860426934
2013,145,3208,61,3390,59,N,0,2,4,1,3,1,2,3,1.741290322580646,5.527419354838706,0.34709677419354845,1.4225806451612915,-1.0032258064516135,-0.7112903225806484,2.3422580645161304,-3.8348387096774204,3.0129032258064523,0.992903225806451,5.546451612903226,-0.5003225806451614,1.2867741935483856
2013,145,3246,69,3174,62,N,0,7,2,6,-4,-1,-7,4,-5.226851851851855,-10.191666666666663,-2.2,-7.569444444444445,0.7666666666666657,1.723148148148148,-2.1009259259259245,2.900000000000002,-0.575925925925926,-1.0092592592592577,-4.871296296296297,-2.278703703703704,-4.166666666666664
2013,146,3181,53,3304,45,N,0,8,2,6,-4,1,8,-4,2.080491004497752,-2.1892803598200885,-1.3537293853073464,-7.95371064467766,-1.2013680659670172,-0.7559970014992494,-1.9956896551724128,0.5997938530734608,-0.6309970014992494,1.776143178410793,1.3261806596701664,2.1405547226386807,1.5310157421289343
2013,146,3257,82,3124,81,N,0,1,5,1,4,-1,-1,-4,4.918682795698924,1.6639784946236489,-2.655913978494624,-7.073924731182792,-0.17741935483870996,0.13776881720430367,-3.4872311827957,2.235887096774192,3.367607526881722,-9.089381720430106,-3.841397849462364,0.509408602150538,-4.277553763440862
2013,146,3323,93,3242,63,N,0,30,1,12,-11,-1,-30,11,-1.6924536564005237,-7.784556998978246,1.0596263319223471,2.5728360823237466,-0.37593052109181,0.8767333236023909,-3.3059407385783093,1.3890672894467961,-1.6047292366077954,1.8281272806889497,-2.1945701357466056,-0.20953145526200556,0.942344183330901
2013,146,3397,74,3328,59,N,0,15,2,6,-4,-1,-15,4,-2.1745129870129887,-3.410768398268395,2.8937229437229437,6.844480519480518,-0.5034090909090914,-0.14388528138528045,-3.1959956709956714,-0.9477272727272741,0.9594696969696965,-0.8884199134199129,-1.8663419913419919,0.1292748917748927,2.123971861471862
2013,147,3143,65,3208,62,N,1,3,2,4,-2,1,3,-2,0.6700000000000017,-0.08809523809524222,0.3316666666666661,0.0011904761904766303,2.3261904761904777,4.050000000000001,2.309047619047618,-0.7938095238095251,-1.5547619047619055,0.47119047619047727,-0.6447619047619053,-0.4030952380952382,-1.2316666666666656
2013,147,3163,83,3246,53,H,0,30,1,2,-1,1,30,-1,3.119412515964239,-1.9051724137931103,0.5172413793103452,0.27250957854406366,-1.1896551724137936,-2.6348978288633464,-1.943167305236269,6.561781609195407,7.441890166028099,1.2982120051085584,-1.8235951468710088,0.4327905491698596,-3.063218390804595
2013,148,3257,86,3397,78,N,0,8,5,2,3,1,8,3,-1.5059523809523796,-3.157738095238088,0.5952380952380958,4.095238095238093,-2.0625,-1.1488095238095255,-0.6577380952380949,-5.3125,0.875,0.42559523809523725,3.648809523809522,0.01488095238095255,0.9940476190476204
2013,148,3323,87,3181,76,N,0,11,1,2,-1,-1,-11,1,-1.3270300333704128,-8.329532814238036,0.6607341490545053,-1.4240823136818683,-2.3003337041156833,-1.9958286985539502,-3.523915461624025,1.7071746384872064,-3.471635150166854,2.5600667408231352,-1.6982758620689644,0.8845939933259177,-0.06479421579532918
2013,153,3163,83,3323,65,N,0,18,1,1,0,1,18,0,2.754866518353726,-2.8769466073414947,2.936596218020023,7.0328142380422705,-2.0848164627363737,-2.926863181312571,-1.2954671857619573,4.599416017797555,2.1231924360400427,2.853170189099,-0.568965517241379,2.3932146829810903,-0.0820355951056726
2013,153,3257,64,3143,57,N,0,7,5,2,3,-1,-7,-3,-1.3958333333333357,2.595238095238088,-1.0416666666666679,-2.4404761904761862,1.2261904761904763,3.1458333333333357,4.1398809523809526,0.9136904761904745,-2.383928571428571,-2.544642857142856,-1.9880952380952372,-0.8214285714285712,-0.5208333333333357
2013,155,3163,93,3257,60,N,0,33,1,5,-4,1,33,-4,4.867097701149422,3.8031609195402183,1.6839080459770113,2.21695402298851,-1.9396551724137936,-4.095545977011492,-0.12140804597701305,5.915948275862071,6.555316091954024,-0.17169540229884817,-1.6522988505747112,2.8864942528735638,-0.8757183908045985
2014,138,3113,69,3435,61,N,0,8,9,8,1,1,8,1,-1.2904040404040416,3.5580808080808026,-1.5277777777777777,-0.742424242424244,0.4747474747474758,2.883838383838384,2.550505050505052,1.1262626262626299,-3.113636363636365,-0.46212121212121104,0.6136363636363642,1.3207070707070707,0.8383838383838409
2014,138,3124,87,3443,74,H,0,13,2,15,-13,1,13,-13,4.007183908045974,11.099856321839084,-0.1896551724137936,-0.6609195402298838,3.596264367816092,4.3584770114942515,4.919540229885055,6.484195402298852,5.503591954022987,-0.7909482758620694,-2.40373563218391,1.5100574712643677,1.818247126436784
2014,138,3140,72,3301,57,N,0,15,12,5,7,1,15,7,-3.7067307692307736,-6.080815018315022,-1.4571886446886442,-4.279990842490843,2.3152472527472536,3.081272893772894,-2.9464285714285694,6.514880952380956,-0.7582417582417591,2.521291208791208,-1.584020146520146,3.1078296703296706,-0.6055402930402956
2014,138,3143,64,3200,63,N,0,1,7,10,-3,1,1,-3,0.8120634920634906,5.772063492063495,-3.2438095238095244,-6.067936507936507,4.6158730158730155,8.583809523809524,2.6012698412698416,1.1428571428571423,-3.4495238095238108,0.7228571428571406,2.308888888888889,0.7257142857142851,1.6273015873015915
2014,138,3177,104,3328,100,N,0,4,7,10,-3,1,4,-3,3.4231307907778508,7.032643826761472,1.8510558069381595,4.320135746606336,-3.6322452057746197,-2.8757272139625094,1.9095561301443666,-4.6507756948933405,5.231577246283127,-1.5683042447748345,3.036414565826332,-0.9450549450549453,-0.6950549450549453
2014,138,3181,87,3457,45,H,0,42,2,15,-13,1,42,-13,3.1203703703703702,-1.212962962962962,0.9699074074074074,-1.0092592592592595,-1.356481481481481,-0.18750000000000355,-0.8194444444444464,-0.856481481481481,1.2824074074074066,3.1550925925925917,-0.17824074074074048,1.2152777777777768,-0.14351851851851904
2014,138,3199,55,3235,44,A,0,11,10,7,3,1,11,3,3.7272727272727266,6.018181818181823,-4.322727272727272,-11.813636363636364,-3.709090909090907,-0.663636363636364,4.813636363636364,-0.6340909090909079,0.4090909090909083,5.9931818181818155,5.061363636363636,0.6772727272727268,0.6090909090909093
2014,138,3246,106,3460,60,H,0,46,3,14,-11,1,46,-11,0.21333333333333826,-3.1741666666666504,-2.8658333333333337,-8.588333333333338,-1.7983333333333338,-0.8241666666666632,1.425833333333335,1.8941666666666634,1.3499999999999996,2.324166666666665,-1.0258333333333312,1.1083333333333334,0.25166666666666515
2014,138,3304,74,3201,55,N,0,19,4,13,-9,-1,-19,9,-2.3772222222222226,-2.071111111111108,1.1644444444444435,3.8944444444444457,-0.5061111111111103,0.01666666666666572,0.13222222222222335,-3.717222222222219,-2.575555555555553,1.0527777777777771,2.767777777777777,-0.03944444444444439,3.0805555555555557
2014,138,3323,93,3352,42,N,0,51,1,16,-15,1,51,-15,8.270968614718615,3.39231601731602,-0.9798430735930737,-5.812905844155843,2.5758928571428577,1.2854437229437252,-1.050054112554113,1.6747835497835482,6.661525974025974,-1.6873647186147167,3.1488095238095237,0.7993777056277054,-4.236877705627705
2014,138,3329,61,3195,60,N,1,1,5,12,-7,-1,-1,7,-3.1010511227902526,-6.678929765886288,5.5232620640229335,14.870222169135214,-2.688455566172957,-3.4973423315814607,-5.04762900143335,-3.395335642618253,0.3605470616340192,0.7468048256091748,0.12747849976110892,1.0203655040611563,-0.9590898232202605
2014,138,3345,84,3103,55,H,0,29,4,13,-9,-1,-29,9,3.333964646464647,2.848033910533914,-0.49864718614718573,1.091810966810968,0.44480519480519476,0.6650432900432897,-0.1757756132756132,2.0654761904761934,2.5487012987012996,-1.0658369408369417,-1.842442279942281,-2.1018217893217894,-0.3165584415584419
2014,138,3385,71,3425,68,N,0,3,8,9,-1,1,3,-1,-0.4833333333333343,-2.491666666666667,-0.978787878787879,-3.462878787878788,0.889393939393937,1.7674242424242443,-0.1977272727272723,-0.8333333333333321,-3.25,-0.31969696969697026,-1.8962121212121206,0.39621212121212146,-0.2219696969696976
2014,138,3390,81,3377,62,N,0,19,2,15,-13,-1,-19,13,-1.7012014354813516,-5.755734123888274,-0.2968741873407188,-2.1736620377593994,4.532558381442762,5.452306652103815,-1.9593020231965461,-5.117387007853537,-0.8558017371404816,3.142663962136581,2.5380194518125556,-1.43316690071254,3.4066156966765533
2014,138,3393,59,3151,53,N,0,6,6,11,-5,-1,-6,5,-1.383402995471961,-4.56365377917102,-1.7618425635667023,-5.519766631835598,-1.5595611285266457,-1.9710031347962413,-4.014019505398814,1.689916405433646,-0.24146638801811093,-2.461250435388365,-3.142981539533263,-0.7062870080111452,-2.2494775339602917
2014,138,3397,70,3322,46,H,0,24,1,16,-15,-1,-24,15,-5.223001949317741,-8.778996101364527,1.109844054580897,4.689376218323584,-3.7433723196881097,-4.555653021442495,-6.992300194931772,-3.7272417153996074,-0.8534113060428847,-4.298294346978558,-0.8777290448343074,-0.6774853801169591,-1.9415204678362574
2014,139,3163,87,3341,44,H,0,43,1,16,-15,1,43,-15,9.443277310924369,1.4306722689075642,3.0399159663865545,5.315126050420167,-5.409663865546218,-9.006302521008404,-2.4831932773109244,6.32563025210084,11.394957983193276,-6.037815126050418,0.7436974789915975,4.1281512605042,-9.258403361344536
2014,139,3196,83,3173,69,N,0,14,11,6,5,-1,-14,-5,2.9830690857578723,7.447245831971237,0.30978260869565233,0.7072436526097867,-0.16360193963168967,-0.9830282227307414,2.337215320910971,4.216070066470522,2.5142884384875224,0.1655361229159844,-1.4431322872398376,1.9885719734117906,0.17353165522501968
2014,139,3234,87,3265,65,H,0,22,6,11,-5,1,22,-5,4.319088319088316,9.194266381766383,-1.1023860398860394,-1.0559116809116844,0.6506410256410255,0.8830128205128176,3.3782051282051277,0.764957264957264,1.2056623931623918,1.6558048433048427,1.5911680911680914,2.2726139601139606,6.3441951566951555
2014,139,3241,72,3211,63,N,0,9,11,6,5,-1,-9,-5,0.45197044334975445,3.9924876847290705,-0.8975369458128073,-1.298399014778326,-3.933866995073892,-2.3195812807881744,1.4311576354679794,-3.586083743842366,-0.7987684729064046,-3.9156403940886726,3.2891625615763544,-1.0192118226600986,-0.637931034482758
2014,139,3257,88,3225,42,N,0,46,3,14,-11,-1,-46,11,-0.8646739130434753,1.4675724637681142,1.480253623188406,7.042753623188407,0.8028985507246382,0.6266304347826086,-1.5143115942028995,2.684239130434783,0.06847826086956488,-3.6695652173913054,-2.289311594202899,0.7855072463768114,-3.167753623188407
2014,139,3261,98,3210,78,H,0,20,7,10,-3,-1,-20,3,3.4285486443381146,9.060885167464114,1.151315789473684,5.053349282296651,0.26275917065390786,1.7830940988835735,3.7870015948963314,2.1005980861244,0.1257177033492809,-0.2585326953747966,1.2012759170653915,-0.5475677830940988,1.7923046251993604
2014,139,3268,90,3119,52,H,0,38,4,13,-9,-1,-38,9,-7.75595238095238,-6.354166666666664,1.446428571428572,2.6220238095238084,0.8839285714285712,0.7797619047619051,-1.4553571428571441,-1.4315476190476168,-7.083333333333332,-2.142857142857144,-2.5238095238095237,-0.5148809523809526,3.1488095238095255
2014,139,3277,91,3214,61,N,0,30,5,12,-7,-1,-30,7,-2.7961760461760434,4.526334776334778,-0.026334776334776322,1.816558441558442,1.6940836940836927,5.617243867243868,6.193903318903317,-3.3414502164502196,-3.5992063492063497,-0.8324314574314577,2.1320346320346317,0.04166666666666696,2.609487734487736
2014,139,3314,60,3404,58,H,0,2,4,13,-9,1,2,-9,2.298611111111107,1.392857142857153,-3.1101190476190492,-9.147817460317459,0.1190476190476204,3.2678571428571423,3.799603174603174,2.9682539682539684,0.7361111111111107,5.194444444444446,1.9831349206349191,2.1240079365079367,2.391865079365079
2014,139,3333,55,3292,36,N,0,19,9,8,1,-1,-19,-1,-2.480015673981189,-1.645846394984325,-2.6196708463949836,-2.9460815047021924,3.3944357366771154,6.856739811912224,1.3195141065830729,-4.086990595611283,-1.1113636363636363,-0.10721003134796447,1.9108934169279,-4.109326018808777,0.6047021943573689
2014,139,3336,62,3455,56,H,0,6,3,14,-11,1,6,-11,1.628038628038631,6.584915084915089,-0.3637196137196135,-2.9097569097569114,3.1143856143856183,0.9743589743589745,2.7440059940059935,6.154678654678655,0.43639693639693533,2.0588578088578107,-1.1986346986346987,1.2579920079920086,-0.6341991341991324
2014,139,3376,73,3169,58,N,0,15,1,16,-15,-1,-15,15,0.018518518518519045,8.181216931216923,4.037698412698413,11.592592592592592,-4.614417989417989,-8.395502645502642,2.8167989417989414,-2.6832010582010604,2.894179894179892,1.018518518518519,2.5562169312169303,-2.8730158730158735,2.647486772486772
2014,139,3386,67,3208,57,N,0,10,9,8,1,-1,-10,-1,-1.0406698564593277,-0.5197235513025049,0.2003987240829339,3.7441254651780937,-3.0009569377990424,-0.15050505050505336,4.213237639553428,-1.8760233918128648,-1.9588782562466776,3.6108984582668775,1.93888888888889,-0.4766347687400314,0.8552099946836798
2014,139,3400,79,3335,61,N,0,18,5,12,-7,-1,-18,7,-2.9080086580086615,-2.396103896103888,-0.8755411255411252,1.2391774891774894,0.020562770562770893,-0.4166666666666643,-3.388528138528139,-1.6569264069264094,-0.7316017316017334,-4.282467532467532,0.3690476190476186,0.8290043290043281,-6.974025974025974
2014,139,3401,70,3315,55,H,0,15,3,14,-11,-1,-15,11,-3.7013888888888893,-5.754166666666663,0.8888888888888884,3.2736111111111104,4.730555555555554,6.06666666666667,1.0027777777777782,2.490277777777777,-2.469444444444445,3.7666666666666657,0.018055555555555713,0.4041666666666659,-0.7624999999999993
2014,139,3452,76,3107,61,N,0,15,2,15,-13,-1,-15,13,-0.4464285714285694,-4.660714285714278,-1.3571428571428568,-4.125,-3.1607142857142865,-4.339285714285715,-0.01785714285714235,-1.3571428571428577,1.4642857142857135,4.857142857142858,0.8928571428571423,-1.7857142857142856,0.1607142857142847
2014,140,3124,75,3143,56,N,0,19,2,7,-5,1,19,-5,3.9913108921729616,6.878626163108919,0.6912972085385878,0.662493158182814,4.193486590038313,3.3019293924466346,3.1199370552818806,0.775862068965516,5.810139573070607,-0.3891625615763541,0.05261357416529755,1.694581280788178,3.6208264915161443
2014,140,3140,80,3304,76,N,0,4,12,4,8,1,4,8,-2.799230769230771,-5.783076923076919,-1.0389743589743592,-1.7948717948717956,1.9684615384615398,4.212820512820514,0.5433333333333348,0.11333333333333684,-0.13538461538461277,3.206410256410255,-0.49461538461538446,2.881282051282052,4.547435897435896
2014,140,3177,74,3181,65,N,0,9,7,2,5,1,9,5,0.6809116809116809,6.488603988603984,3.5220797720797723,12.015669515669515,2.7378917378917365,2.935897435897438,0.27136752136752307,-2.28133903133903,3.9964387464387467,-3.0733618233618234,1.9074074074074083,-2.8418803418803416,5.287749287749289
2014,140,3246,64,3393,59,N,0,5,3,6,-3,1,5,-3,2.21717171717172,1.5239898989899103,-2.2891414141414153,-7.5441919191919204,2.702651515151514,5.6439393939393945,-0.46085858585858297,1.706439393939391,-0.9160353535353529,0.44823232323232354,-1.2342171717171695,-0.7127525252525246,3.2670454545454533
2014,140,3323,84,3113,67,N,0,17,1,9,-8,-1,-17,8,-9.380997474747474,-4.837121212121218,-1.214962121212121,0.6429924242424239,-0.17329545454545325,2.1875,0.3213383838383841,-4.344696969696969,-8.341540404040405,1.7743055555555571,-1.7714646464646462,-2.045770202020202,3.5464015151515156
2014,140,3329,73,3345,66,N,0,7,5,4,1,1,7,1,-0.008152173913043015,0.7144151138716381,-1.790890269151138,-2.970496894409937,-3.2804089026915104,-1.3355331262939956,0.9723084886128373,1.7565993788819902,-2.2854554865424426,-2.558618012422361,0.3237577639751539,-1.435429606625259,-0.866459627329192
2014,140,3390,63,3199,44,N,0,19,2,10,-8,-1,-19,8,-0.7235893416927901,-3.818887147335417,-1.8074973876698017,-4.679153605015673,-1.0389759665621732,0.8248693834900749,0.101280041797283,-5.6605276907001,-0.8501044932079438,7.579963427377219,5.201306165099268,-0.3669801462904916,-0.8374608150470202
2014,140,3397,67,3385,51,N,0,16,1,8,-7,-1,-16,7,-4.093097643097643,-6.701683501683505,-0.5220538720538719,-1.435185185185187,-1.9604377104377129,-1.3271043771043765,-4.89158249158249,-2.8638047138047114,-3.066329966329967,-1.6516835016835003,-0.6048821548821541,0.10808080808080822,1.9383838383838388
2014,141,3163,91,3386,52,N,0,39,1,9,-8,1,39,-8,5.8114973262032095,0.608140225787281,2.332442067736185,5.304961378490788,-1.2419786096256686,-0.932857991681523,1.0164884135472363,4.59967320261438,5.894682115270349,-0.8103089720736776,3.4035947712418313,5.242869875222816,-7.829619726678549
2014,141,3257,83,3234,53,N,0,30,3,6,-3,-1,-30,3,2.2153846153846146,-0.7464743589743605,-0.047756410256409865,0.45705128205128176,3.125641025641025,3.7913461538461526,-3.6967948717948715,-1.2461538461538453,2.5778846153846136,-2.2182692307692307,0.028205128205128105,1.7439102564102567,1.5766025641025614
2014,141,3261,76,3452,67,N,0,9,7,2,5,1,9,5,0.7493734335839619,-0.2810150375939813,-0.9191729323308264,-5.1221804511278215,-1.7562656641604022,-3.500626566416038,0.6604010025062657,-1.1531954887218028,-0.7302631578947363,3.3903508771929793,0.481516290726816,-0.12061403508771917,0.9758771929824555
2014,141,3268,69,3400,64,N,0,5,4,5,-1,1,5,-1,5.141233766233761,5.109577922077925,-0.5668290043290041,-0.22483766233766467,0.48268398268398194,-1.0321969696969688,0.3652597402597415,-4.128517316017319,3.2930194805194795,-3.9055735930735906,2.4485930735930737,-1.358495670995671,-4.258116883116884
2014,141,3314,62,3277,53,N,0,9,4,5,-1,-1,-9,1,-2.469696969696969,-5.50252525252526,0.5025252525252526,0.4949494949494948,-3.9797979797979792,-7.989267676767678,-3.594696969696969,2.0101010101010104,0.47916666666666785,-1.3560606060606055,-4.567550505050503,-0.43055555555555625,-2.304924242424242
2014,141,3336,83,3196,61,N,0,22,3,11,-8,-1,-22,8,-0.3971007063112353,-5.235218728639786,1.9951298701298699,5.485161768056507,-2.3935691501480996,-1.201754385964911,-3.740800865800864,-3.9487069947596254,1.1035828206880858,1.0867224880382782,0.3465766689450902,-2.594867851446799,-0.4886078833447236
2014,141,3376,78,3333,69,N,0,9,1,9,-8,-1,-9,8,-0.8122895622895605,2.088215488215482,4.827525252525252,11.689057239057238,-3.7600168350168346,-6.471043771043767,1.6792087542087533,0.010521885521882268,1.1900673400673387,2.3134680134680146,-0.1059764309764315,-0.608585858585859,1.9803872053872063
2014,141,3401,85,3241,69,N,0,16,3,11,-8,-1,-16,8,0.45535714285714235,2.6720238095238074,3.2869047619047613,10.182738095238095,1.2571428571428562,0.22619047619047805,2.93809523809524,1.5839285714285722,-0.7357142857142858,1.2619047619047628,-0.456547619047619,0.5113095238095227,2.3125
2014,145,3124,90,3246,72,N,0,18,2,3,-1,1,18,-1,1.257183908045974,4.16235632183907,-0.23132183908045967,-0.4942528735632159,3.783764367816092,2.9209770114942515,2.2528735632183885,4.546695402298852,5.170258620689655,-0.6451149425287355,-1.5912356321839098,1.1558908045977012,1.693247126436784
2014,145,3163,70,3140,51,N,0,19,1,12,-11,-1,-19,11,-8.906485671191554,-7.354449472096533,-2.055052790346908,-3.3978129713423826,4.136500754147814,6.478506787330318,-0.2892156862745079,-1.4607843137254868,-6.0908748114630455,5.432880844645549,-4.565987933634993,-2.600678733031673,6.769984917043738
2014,145,3323,89,3329,72,N,0,17,1,5,-4,1,17,-4,7.601902173913043,1.657608695652172,0.476902173913043,-2.4089673913043477,2.618206521739131,1.070652173913043,-0.3532608695652186,1.6005434782608674,7.877717391304348,0.5720108695652186,1.2744565217391308,1.2404891304347827,-2.5040760869565233
2014,145,3401,84,3177,65,N,0,19,3,7,-4,-1,-19,4,3.613782051282051,7.296474358974365,5.846153846153846,15.90224358974359,0.1314102564102555,1.1025641025641058,0.7852564102564124,-2.5336538461538467,4.153846153846153,-0.9807692307692317,3.770833333333334,-2.2516025641025648,2.08173076923077
2014,146,3257,73,3261,47,N,0,26,3,7,-4,1,26,-4,0.864912280701752,2.6298245614035096,2.1846491228070173,6.941228070175438,-2.909210526315789,-3.610087719298246,-0.7342105263157901,2.8210526315789437,1.580263157894736,-0.46535087719297863,0.6482456140350887,-0.8877192982456141,-1.884210526315787
2014,146,3268,73,3397,62,N,0,11,4,1,3,1,11,3,1.8712962962962933,0.7615740740740691,0.5078703703703704,2.71898148148148,-2.2740740740740755,-4.403240740740742,-2.345370370370368,-1.638425925925926,3.5643518518518515,-2.5384259259259245,0.556481481481482,-0.17638888888888848,0.23611111111111072
2014,146,3314,65,3376,58,N,0,7,4,1,3,1,7,3,3.268518518518519,10.68518518518519,2.180555555555555,7.425925925925927,0.4490740740740744,0.5717592592592631,4.453703703703702,-2.643518518518519,2.752314814814813,3.018518518518519,6.178240740740739,-1.958333333333333,3.956018518518519
2014,146,3390,82,3336,57,N,0,25,2,3,-1,-1,-25,1,-0.5388490819525273,-1.2386923421406095,-2.329899985072399,-7.676556202418272,3.9421928646066604,3.738505747126439,-0.5048887893715488,-2.5615017166741296,-2.320234363337814,4.277690700104495,4.121436035229138,1.379123749813405,3.135915808329603
2014,147,3163,69,3401,54,N,0,15,1,3,-2,1,15,-2,5.533088235294116,1.8688725490196134,5.112745098039215,11.832107843137253,-2.139705882352942,-4.299019607843135,-1.7524509803921564,5.3566176470588225,6.5588235294117645,-3.5931372549019613,2.118872549019608,3.464460784313724,-7.143382352941176
2014,147,3323,88,3124,69,H,0,19,1,2,-1,-1,-19,1,-3.8157327586206904,6.995689655172413,-0.2834051724137936,3.2661637931034484,2.919181034482758,4.691810344827587,3.8987068965517224,1.650862068965516,-2.829741379310345,-0.1346982758620694,-2.612068965517242,0.4579741379310347,6.453663793103448
2014,148,3268,76,3257,73,A,0,3,4,3,1,-1,-3,-1,-3.8916666666666657,-0.9874999999999972,1.6375000000000002,4.179166666666665,-1.8083333333333336,-1.5124999999999993,-0.8833333333333346,0.8791666666666664,-3.9625000000000004,1.6958333333333329,0.8083333333333336,0.012499999999999734,1.2166666666666686
2014,148,3390,74,3314,65,H,0,9,2,4,-2,-1,-9,2,1.4185823754789268,0.22126436781610437,-0.543103448275863,-1.187739463601531,1.7701149425287355,5.467672413793107,0.8098659003831408,-4.598659003831415,0.439415708812259,6.214559386973182,7.121886973180075,0.7696360153256707,3.3881704980842926
2014,153,3163,75,3390,56,N,0,19,1,2,-1,1,19,-1,4.6947261663286,-3.5973630831642964,1.5696416497633532,0.8874239350912774,-1.9945909398242065,-3.393847194050032,-3.581473968897905,-0.3323191345503709,6.949628127112913,0.26031102096010983,5.379648411088574,4.241041244083839,-5.602434077079105
2014,153,3323,87,3268,61,N,0,26,1,4,-3,-1,-26,3,-3.1145833333333357,-0.5208333333333357,-0.32291666666666696,2.572916666666666,-2.71875,-3.125,0.7291666666666679,-2.604166666666668,-2.875,0.32291666666666785,-1.75,-1.114583333333333,1.65625
2014,155,3163,79,3323,58,N,0,21,1,1,0,1,21,0,-1.185661764705884,-1.610294117647058,2.4356617647058822,7.821691176470587,-3.983455882352942,-5.444852941176471,-2.3566176470588243,2.6691176470588225,0.8713235294117645,-2.7077205882352935,0.139705882352942,4.141544117647058,-4.174632352941176
2015,137,3116,57,3321,55,N,0,2,10,7,3,1,2,3,-5.908543183159551,-5.601072201455835,-1.1905862679519963,-1.057876746016131,0.9107810348219552,2.4727646075152485,2.461144993114303,0.6110441668306095,-5.814860810544955,-1.373475309856385,-3.1298322840842028,-2.2218547117843794,0.3260992524099926
2015,137,3124,77,3322,36,N,0,41,2,15,-13,1,41,-13,8.545238095238094,9.419047619047618,-3.1547619047619047,-10.24285714285714,0.5595238095238102,0.9333333333333371,3.9404761904761916,4.190476190476193,6.223809523809525,1.4214285714285708,-0.026190476190476097,3.2071428571428573,2.876190476190473
2015,137,3143,78,3455,66,N,0,12,4,13,-9,1,12,-9,2.1732050641345992,2.2311344327836125,-0.9519406963185064,-2.7769240379810096,2.6223763118440786,5.9351990671331,0.16754122938530713,4.93378310844578,3.3869315342328843,1.5315675495585541,-1.6346618357487923,0.31546726636681655,-1.604093786440112
2015,137,3173,78,3235,66,N,0,12,7,10,-3,1,12,-3,2.0266666666666673,4.011666666666663,-2.516111111111112,-7.768333333333334,2.2833333333333314,4.197222222222219,2.5700000000000003,0.9938888888888897,-2.2055555555555557,4.765555555555554,2.719444444444445,2.572777777777777,5.777222222222219
2015,137,3177,79,3278,72,N,0,7,9,8,1,1,7,1,4.295482295482298,10.391715772150562,4.085881509794554,10.356452726017945,-1.4938153633805804,-0.4872723894463036,1.9034081860168826,-4.756795137229922,1.4446567924828813,-3.769005149439934,4.978367043584434,-3.268341561819823,2.49248818814036
2015,137,3181,54,3107,52,N,0,2,4,13,-9,-1,-2,9,-0.07619047619047592,-4.880357142857136,-2.2666666666666666,-6.6035714285714295,1.239880952380954,1.509523809523806,-2.239285714285714,-5.666666666666671,0.15119047619047699,-0.4208333333333343,1.4029761904761902,-4.477380952380952,1.8702380952380935
2015,137,3211,82,3203,69,N,0,13,11,6,5,-1,-13,-5,4.476190476190478,9.770833333333343,-1.458333333333334,-3.3363095238095255,-3.654761904761905,-2.8482142857142847,2.5773809523809526,2.166666666666668,1.696428571428573,2.0565476190476204,1.229166666666666,-2.0416666666666665,1.2886904761904745
2015,137,3234,75,3110,67,N,0,8,3,14,-11,-1,-8,11,-6.026785714285712,-12.529761904761898,-3.5892857142857144,-6.8273809523809526,-0.18452380952380842,-0.0238095238095255,-2.8482142857142865,-1.5208333333333286,-2.6101190476190474,0.08035714285714235,-0.0327380952380949,-1.821428571428572,-1.5773809523809526
2015,137,3246,97,3398,52,N,0,45,2,15,-13,1,45,-13,1.2892512077294676,3.2578502415458956,-0.8701690821256047,-2.4045893719806752,4.0012077294686,3.9051932367149718,1.1865942028985508,0.2934782608695663,-1.971014492753623,-0.9855072463768124,-0.1521739130434785,1.3544685990338161,-0.028985507246375164
2015,137,3274,86,3449,80,N,0,6,11,6,5,1,6,5,-0.8965484363081622,2.0567632850241537,-1.30720823798627,-1.465071192473939,-2.6139397406559866,-0.4843312992626494,4.259598271039916,-3.0140160183066342,-1.059877955758962,2.097317569285531,2.0005403000254267,0.7146580218662595,3.7364607170099173
2015,137,3280,57,3408,47,N,0,10,5,12,-7,1,10,-7,1.618414918414917,5.148135198135201,0.6953379953379955,0.3822843822843822,6.273076923076923,8.435198135198135,3.5644522144522135,-0.582284382284378,-0.13088578088578018,0.4737762237762233,-0.3811188811188799,0.9613053613053619,6.346270396270398
2015,137,3323,77,3285,43,N,0,34,1,16,-15,-1,-34,15,-3.9182551319648056,-3.418804985337239,1.7291055718475077,5.174303519061581,-3.0408724340175954,-2.759164222873899,0.11913489736070204,1.7828079178885616,-2.51008064516129,-2.857038123167154,-2.3453079178885634,1.655241935483871,-1.3267961876832821
2015,137,3333,74,3355,62,N,0,12,3,14,-11,1,12,-11,0.8233333333333377,2.8783333333333303,1.2366666666666664,6.479166666666664,-6.673333333333336,-7.504999999999999,0.8166666666666682,1.5483333333333356,3.1833333333333336,-2.0516666666666676,-1.2416666666666663,1.101666666666667,-2.2816666666666663
2015,137,3376,81,3366,48,N,0,33,1,16,-15,-1,-33,15,-2.96842105263158,-3.2798245614035153,-2.410526315789474,-2.5175438596491233,-0.6298245614035096,-2.026315789473685,-3.686842105263157,-2.420175438596491,-3.0473684210526315,1.438596491228072,3.5403508771929832,-3.3333333333333335,2.3447368421052666
2015,137,3393,72,3304,69,N,0,3,8,9,-1,-1,-3,1,0.05079365079365061,-3.194444444444457,-2.0928571428571434,-7.089682539682542,-2.8912698412698408,-5.884920634920633,-5.158730158730158,5.989682539682541,1.837301587301587,-0.5277777777777768,-4.536507936507936,-1.8801587301587297,-3.790476190476191
2015,137,3400,66,3443,64,N,0,2,5,12,-7,1,2,-7,-2.0219696969696983,-0.9553030303030354,-1.13030303030303,-3.7681818181818194,-0.827272727272728,-2.925757575757576,0.32196969696969546,4.253787878787875,0.8098484848484837,-0.9409090909090914,-3.9318181818181817,0.005303030303030809,1.8500000000000014
2015,138,3113,74,3325,55,N,0,19,3,14,-11,1,19,-11,0.7416666666666671,-1.0888888888888886,-4.050925925925926,-12.851851851851851,-0.2157407407407419,-0.9435185185185162,2.844444444444445,-3.723148148148148,0.5314814814814817,-1.1648148148148145,-0.2092592592592588,-0.6009259259259259,-5.103703703703703
2015,138,3114,69,3401,60,N,0,9,11,6,5,1,9,5,-1.7716528640441709,-2.4978433402346525,2.2220496894409942,5.4021739130434785,-1.4754140786749481,-2.5816080055210477,-0.03597308488612683,-5.526570048309178,0.5121635610766049,1.93348861283644,2.6732229123533475,-1.1319875776397517,0.9556590752242933
2015,138,3163,89,3383,33,N,0,56,1,16,-15,1,56,-15,10.318402777777777,14.41909722222222,3.0961805555555557,5.334027777777777,3.3166666666666664,6.530555555555555,4.861805555555556,3.07534722222222,4.99861111111111,-1.6559027777777775,1.4312500000000004,5.382638888888889,3.8701388888888886
2015,138,3195,75,3329,67,N,0,8,7,10,-3,1,8,-3,1.2508620689655174,1.0578369905956109,7.3657523510971785,18.63981191222571,1.6267241379310349,0.8927115987460823,-2.7133228840125394,-3.295062695924763,0.6036050156739812,-1.989890282131661,-0.6384796238244519,-0.919592476489028,2.048119122257054
2015,138,3199,91,3106,49,N,0,42,2,15,-13,-1,-42,13,-6.264162561576356,-8.669950738916256,-0.6773399014778319,-1.9507389162561584,2.8540640394088665,5.683497536945811,-2.5080049261083737,2.9722906403940854,-2.1311576354679804,2.60960591133005,-2.0911330049261068,1.318965517241379,3.004310344827587
2015,138,3257,86,3140,53,N,0,33,3,14,-11,-1,-33,11,-1.5364646464646476,-5.405353535353541,2.721414141414142,5.871515151515153,-0.3862626262626243,-2.7677777777777806,-5.30989898989899,-0.06929292929293496,0.08363636363636573,-1.237373737373737,-3.7067676767676776,-1.1658585858585857,-3.693434343434344
2015,138,3268,75,3308,57,N,0,18,1,16,-15,1,18,-15,2.422619047619051,-2.2059523809523824,-2.5821428571428573,-9.564285714285713,0.9071428571428566,-0.7571428571428598,0.7309523809523828,-1.0154761904761926,0.5059523809523814,-0.027380952380955392,-2.178571428571429,-0.6202380952380953,0.6428571428571423
2015,138,3314,71,3251,65,N,0,6,4,13,-9,-1,-6,9,-2.6858974358974343,-6.538461538461547,-1.7996794871794863,-4.979166666666664,-0.7339743589743595,-3.169871794871792,1.8397435897435912,0.0240384615384599,-1.3477564102564124,0.6618589743589745,-2.708333333333334,-0.21314102564102555,0.1073717948717956
2015,138,3326,90,3241,80,N,0,10,5,12,-7,-1,-10,7,-2.5761869065467238,0.5763868065967017,-2.2484007996002005,-4.42701149425287,-0.5751874062968536,0.2352823588205908,4.7461019490254905,-1.6021489255372323,-1.1793603198400806,0.7031234382808602,-0.7406796601699153,-2.204822588705648,3.0466266866566727
2015,138,3328,111,3346,84,N,0,27,5,12,-7,1,27,-7,0.390542521994135,-3.8449902248289334,-1.4004643206256118,-6.039589442815249,-0.181109481915934,-0.3508308895405641,-1.0914467253176934,0.3199902248289348,-4.077517106549365,1.6506598240469206,-1.638954056695992,-1.4432062561094816,-0.6145405669599207
2015,138,3338,51,3151,40,N,0,11,10,7,3,-1,-11,-3,-1.8908870923389927,-9.178958367706102,0.3289336193147445,-1.0816696914700543,-1.0307430017048897,-1.2996480228785146,-3.2534235274707157,-6.003052301600398,-3.0249133806302595,-0.1746411483253585,1.9660672056316333,0.9154979926304794,-4.308914920530164
2015,138,3343,80,3453,70,N,0,10,8,9,-1,1,10,-1,4.909259259259258,-0.20462962962962905,-1.174074074074074,-9.401851851851852,0.5166666666666675,0.5481481481481509,1.0351851851851865,6.571296296296296,1.2148148148148152,0.39351851851851904,0.8148148148148158,1.7490740740740742,-2.712037037037039
2015,138,3353,79,3371,66,N,0,13,8,9,-1,1,13,-1,-0.2567821067821079,-3.4415223665223778,-3.8628787878787882,-12.149999999999999,-1.6405483405483405,-2.886327561327562,1.0658008658008669,-1.6939033189033168,3.2146464646464636,3.69675324675325,-1.1658730158730162,1.3946608946608947,-0.1633477633477618
2015,138,3378,73,3261,64,N,0,9,6,11,-5,-1,-9,5,-0.9573367808661928,-2.526826115061411,-2.297349709114415,-7.484162895927604,-1.3577892695539777,-0.14350355526826064,0.6305753070458948,-5.59744667097608,-0.15772462831286305,3.021170006464123,4.829347123464769,-2.363445378151261,3.6557853910795117
2015,138,3390,73,3169,60,N,0,13,4,13,-9,-1,-13,9,-0.17240338164251412,4.381340579710141,0.5443840579710146,2.695048309178741,0.031099033816424537,0.12892512077294427,2.021135265700483,1.345108695652172,2.5724637681159415,2.521437198067634,0.10688405797101375,-1.6657608695652169,1.8925120772946862
2015,138,3397,72,3129,61,N,0,11,2,15,-13,-1,-11,13,-1.1342592592592595,-0.23703703703703383,3.587037037037037,10.214814814814819,-1.2962962962962976,-1.5657407407407398,-0.2296296296296294,2.0185185185185155,2.075925925925926,4.819444444444446,0.26203703703703685,1.1333333333333342,1.4916666666666671
2015,139,3124,73,3116,44,N,0,29,2,10,-8,-1,-29,8,-8.268325791855204,-6.9162895927601795,2.057239819004525,6.762594268476622,0.06440422322775241,1.851206636500752,0.22926093514328727,-2.0094268476621444,-5.2436651583710425,-1.2999245852187045,-1.3151583710407246,-1.805731523378582,-1.1802413273001484
2015,139,3173,99,3246,94,N,0,5,7,2,5,1,5,5,-0.5542512077294681,-5.246183574879225,1.5485024154589375,1.816811594202898,-0.6623188405797116,-2.5968599033816417,-3.019371980676329,4.408743961352659,2.8487922705314013,0.8621739130434776,-1.5589371980676319,1.60719806763285,-0.4021256038647394
2015,139,3181,64,3280,56,N,0,8,4,5,-1,1,8,-1,0.04413919413919487,-3.134065934065937,-1.7589743589743598,-3.9188644688644665,-3.3087912087912095,-4.682600732600733,0.2937728937728963,5.397435897435898,0.5122710622710613,0.9641025641025642,-0.9366300366300369,1.5062271062271053,-4.9824175824175825
2015,139,3211,76,3333,64,N,0,12,11,3,8,1,12,8,-2.8590476190476224,-5.482500000000002,-2.0700000000000003,-6.854166666666664,5.52452380952381,6.013928571428568,0.6297619047619047,-2.369761904761905,-3.8142857142857167,4.203452380952379,3.3398809523809527,0.3864285714285707,2.492976190476192
2015,139,3234,88,3274,70,N,0,18,3,11,-8,1,18,-8,5.379855889724311,5.008928571428569,1.3973997493734336,0.31751253132832247,-0.004072681704260006,-1.4586466165413547,-1.9708646616541348,-0.2839912280701782,6.850250626566416,-0.7371553884711783,-2.2446741854636603,0.47603383458646675,-0.6364348370927324
2015,139,3323,79,3177,67,N,0,12,1,9,-8,-1,-12,8,4.817883729174056,12.214374335342086,6.1188408365827724,16.6036866359447,-3.03943637008153,-1.7233250620347391,2.183445586671393,-1.663683091102449,3.669177596596951,-3.1534916696207027,3.0482984757178304,-1.4141261963842613,-0.6005848989719951
2015,139,3376,97,3393,68,N,0,29,1,8,-7,1,29,-7,1.617460317460317,-4.739682539682548,-2.230952380952381,-11.358730158730161,-2.393650793650794,-1.7896825396825378,-0.8730158730158735,1.8158730158730165,1.2206349206349216,1.7769841269841269,-3.2484126984126984,1.9198412698412701,0.4499999999999993
2015,139,3400,73,3143,70,N,0,3,5,4,1,-1,-3,-1,0.41097935880544867,0.058563899868254055,0.14962670180061544,1.428326745718051,-1.8770750988142293,-0.8522617479139214,-2.178853754940711,-1.8599472990777315,-0.06745718050065719,-1.1361440491875285,1.0721563460693897,-1.2361001317523064,-3.6859903381642507
2015,140,3113,57,3114,54,N,0,3,3,11,-8,1,3,-8,0.37261904761904674,1.5506613756613774,0.2658730158730158,1.4166666666666679,0.2538359788359781,0.3283068783068792,1.204894179894179,0.37407407407407334,-0.31441798941798815,-2.8837301587301596,-1.821693121693123,-0.7404761904761905,-3.5521164021164022
2015,140,3163,91,3353,55,N,0,36,1,8,-7,1,36,-7,4.675978535353536,2.877683080808083,7.428503787878788,17.90625,3.8762626262626263,5.61489898989899,0.5047348484848477,0.4505997474747474,2.2228535353535364,-3.39630681818182,-1.7743055555555554,1.7705176767676765,-1.5268308080808097
2015,140,3199,65,3195,47,N,0,18,2,7,-5,-1,-18,5,-1.2025862068965552,-4.801724137931032,5.551724137931035,12.474137931034484,-0.23706896551724022,-1.1293103448275836,-5.823275862068964,-2.0646551724137936,1.0646551724137936,-4.379310344827587,-0.5344827586206886,-0.15517241379310365,-1.7112068965517224
2015,140,3257,60,3378,52,N,0,8,3,6,-3,1,8,-3,0.7471428571428582,-0.41021978021977645,-1.7136996336996342,-4.3994871794871795,0.1491941391941367,2.407582417582418,-0.22853479853479897,-2.1557875457875397,4.886227106227105,1.2161172161172153,3.5180952380952384,-1.1205494505494507,3.976373626373629
2015,140,3268,85,3343,70,N,0,15,1,8,-7,1,15,-7,-1.5666666666666629,2.0500000000000043,-1.2333333333333334,-0.6166666666666671,3.083333333333332,1.7666666666666657,2.5,-6.116666666666667,-3.9000000000000004,3.4499999999999975,0.16666666666666607,-1.6500000000000004,4.050000000000001
2015,140,3314,86,3326,84,N,0,2,4,5,-1,1,2,-1,-2.087681159420292,0.694202898550742,-1.4186594202898561,-1.6374999999999993,0.4032608695652158,2.4177536231884034,3.5478260869565226,-1.6617753623188385,-0.7849637681159418,2.458152173913044,3.122826086956522,-1.0719202898550737,3.8461956521739147
2015,140,3390,86,3328,76,N,0,10,4,5,-1,-1,-10,1,2.1604797979798,3.3501262626262616,0.6127525252525254,1.6553030303030276,2.773863636363636,4.6892676767676775,0.5729797979797979,-0.8612373737373744,4.329292929292929,4.8314393939393945,1.5926767676767675,-1.5178030303030297,6.479545454545455
2015,140,3397,77,3338,67,N,0,10,2,10,-8,-1,-10,8,-1.8453836611731376,0.23042707779550398,1.5437356016303392,7.2516569200779735,-2.0919900762006023,-1.973276625908202,-1.603792309055466,2.531915647705123,1.816356547935495,1.919085592769802,-0.38880028353712515,2.113237639553429,0.4594896331738454
2015,144,3124,81,3234,66,N,0,15,2,3,-1,1,15,-1,-0.06011904761904674,-2.7589285714285694,-5.051785714285714,-11.50654761904762,1.4571428571428573,2.234523809523811,1.6726190476190492,4.0625000000000036,-0.44761904761904603,0.5511904761904773,0.8047619047619055,0.5160714285714283,0.27678571428571175
2015,144,3199,66,3113,65,N,0,1,2,3,-1,-1,-1,1,-3.1951149425287397,-8.17286079182631,-1.0900383141762449,-4.462643678160919,0.018614303959131107,-0.3453384418901635,-2.9638250319284793,-4.225063856960411,-1.356289910600255,-3.363409961685825,-1.055683269476372,-1.5643678160919543,-4.404948914431673
2015,144,3323,81,3390,60,N,0,21,1,4,-3,1,21,-3,3.1650985663082416,6.135976702508955,-2.2663530465949817,-4.240591397849464,2.893145161290322,3.1234318996415738,1.6106630824372772,0.6843637992831546,5.683691756272401,2.995295698924732,2.1698028673835115,-0.32190860215053707,2.548387096774192
2015,144,3376,67,3314,65,N,0,2,1,4,-3,-1,-2,3,0.3666666666666636,5.616666666666674,1.3291666666666657,6.679166666666667,2.8083333333333336,2.5416666666666643,-1.25,0.8875000000000028,0.5541666666666671,-0.00416666666666643,3.091666666666667,-1.3791666666666673,1.4875000000000007
2015,145,3163,105,3400,54,N,0,51,1,5,-4,1,51,-4,6.9042613636363654,6.710511363636364,5.604261363636364,11.874431818181819,2.4272727272727277,3.7340909090909093,0.04261363636363669,-1.392329545454544,2.8193181818181827,-3.73721590909091,1.363068181818182,1.930113636363636,-1.96875
2015,145,3173,82,3257,66,N,0,16,7,3,4,1,16,4,-0.28000000000000114,0.6833333333333229,2.1333333333333337,5.159999999999998,2.5233333333333334,1.0266666666666637,-0.33333333333333215,2.923333333333332,-3.013333333333332,1.959999999999999,-1.5466666666666669,2.256666666666666,0.9966666666666626
2015,145,3268,65,3181,55,N,0,10,1,4,-3,-1,-10,3,-2.75714285714286,-1.3238095238095298,-0.9000000000000004,-0.8547619047619044,-1.4857142857142858,0.40714285714285836,1.5142857142857142,4.966666666666669,0.473809523809523,0.20000000000000284,-0.09047619047619015,2.9523809523809517,-3.2452380952380935
2015,145,3397,73,3211,69,N,1,4,2,11,-9,-1,-4,9,-2.37830687830688,-4.749537037037037,1.1370370370370377,4.410648148148152,2.0632275132275133,1.6181878306878303,-0.874867724867725,2.1887566137566132,0.23664021164021065,4.937896825396823,0.9269179894179898,2.1547619047619047,3.5946428571428584
2015,146,3323,77,3124,68,N,0,9,1,2,-1,-1,-9,1,2.2112903225806484,-0.6290322580645125,-1.182258064516129,-4.334408602150539,-0.8973118279569885,-0.37204301075268376,-0.43010752688172005,2.239247311827956,1.7774193548387114,-0.6494623655913969,-0.4225806451612897,1.2010752688172044,0.8682795698924721
2015,146,3376,80,3199,74,N,0,6,1,2,-1,-1,-6,1,0.9284482758620705,4.024712643678157,0.38448275862068915,2.9959770114942543,0.7221264367816094,-0.612068965517242,0.400862068965516,0.4658045977011511,0.6525862068965509,0.5022988505747144,1.6649425287356312,-3.0522988505747124,1.2956896551724135
2015,147,3163,91,3173,70,N,0,21,1,7,-6,1,21,-6,6.530625000000001,4.7435416666666725,3.7539583333333333,7.549583333333334,-0.6999999999999993,0.10833333333333428,0.08624999999999972,-1.9435416666666683,5.004166666666666,-4.704791666666665,0.38124999999999964,0.757083333333334,-3.315416666666664
2015,147,3268,58,3397,48,N,0,10,1,2,-1,1,10,-1,2.074074074074076,-0.25370370370369955,0.6370370370370377,2.264814814814816,1.8537037037037027,0.8592592592592609,-0.2629629629629626,-0.16481481481481453,0.492592592592592,5.027777777777775,1.0370370370370372,-0.18333333333333313,4.716666666666669
2015,153,3163,81,3268,58,N,0,23,1,1,0,1,23,0,4.307291666666664,6.113541666666663,4.640625,10.40625,0.15000000000000036,2.625,-0.6104166666666675,2.836458333333333,4.770833333333334,-5.111458333333331,-0.21875,3.6104166666666666,-2.21875
2015,153,3323,66,3376,65,N,0,1,1,1,0,1,1,0,0.7887096774193516,2.162365591397844,-1.1177419354838714,-0.665591397849461,3.2639784946236556,0.8387096774193523,-2.903225806451612,1.0440860215053789,1.7725806451612893,-1.0505376344086024,0.7892473118279568,-2.4510752688172044,-0.15161290322580712
2015,155,3163,63,3323,53,N,0,10,1,1,0,1,10,0,5.051915322580648,3.1678427419354875,5.608366935483871,11.188508064516128,0.6693548387096779,2.5362903225806477,0.5594758064516121,0.27570564516128826,2.86491935483871,-2.594254032258064,0.20866935483870996,2.561491935483871,-0.2671370967741922
2016,137,3107,61,3196,59,A,0,2,12,5,7,1,2,7,-2.0517676767676747,-12.152356902356914,-3.297979797979798,-10.636784511784512,-1.5220959595959602,-3.8428030303030276,-4.596380471380472,-1.4854797979797958,0.5435606060606073,-6.036826599326599,-1.553661616161616,-2.250631313131313,-6.326599326599325
2016,137,3113,74,3308,52,H,0,22,2,15,-13,1,22,-13,-0.8574999999999982,-0.5041666666666629,-3.0075000000000003,-6.337500000000002,1.5491666666666646,1.0200000000000014,2.0700000000000003,-0.943333333333328,1.9108333333333345,-1.9958333333333318,-1.5325000000000006,-1.6150000000000002,-0.5691666666666677
2016,137,3120,68,3385,57,N,0,11,9,8,1,1,11,1,-2.3497330282227296,-0.13615560640732838,1.197972285786931,4.996249682176458,-1.402237477752351,-1.5572400203407106,2.398201118738875,-2.645690312738367,-0.3139143147724397,4.205727180269516,3.204741927281974,-0.4148232901093314,1.7433892702771416
2016,137,3124,89,3225,59,H,0,30,1,16,-15,1,30,-15,-0.5984848484848513,-3.863636363636374,-6.02020202020202,-15.98737373737374,-2.4797979797979792,-3.643939393939391,1.6616161616161627,-0.18686868686868863,0.0429292929292906,1.9065656565656575,1.2803030303030294,1.25,-0.5
2016,137,3177,97,3241,67,N,0,30,6,11,-5,1,30,-5,6.416574074074074,0.23611111111111427,2.495,2.6268518518518533,-1.7794444444444455,-2.8792592592592605,-3.348796296296296,-4.24388888888889,7.516666666666666,-1.4774074074074068,0.9221296296296311,-1.961018518518519,-3.9251851851851853
2016,137,3243,56,3203,51,N,0,5,9,8,1,-1,-5,-1,4.553418803418801,13.284188034188027,-2.3151709401709404,-6.854700854700853,-1.0309829059829063,-1.7916666666666643,9.807692307692307,4.0000000000000036,0.17521367521367637,1.463675213675213,-2.7735042735042734,-0.03205128205128194,1.5405982905982896
2016,137,3257,87,3146,60,H,0,27,3,14,-11,-1,-27,11,-3.7317857142857136,-5.882976190476192,-1.7936904761904766,-3.9378571428571405,-2.2816666666666663,-2.9595238095238123,-1.1039285714285718,0.28369047619047905,-2.595119047619047,1.5938095238095258,-3.123452380952381,0.6497619047619043,-0.12738095238095326
2016,137,3277,74,3125,60,N,0,14,4,13,-9,-1,-14,9,-0.6666666666666643,-2.5852272727272734,2.1515151515151523,2.6856060606060623,-3.1837121212121193,-3.0473484848484826,-0.5833333333333321,1.3977272727272734,1.2689393939393927,-2.8996212121212146,-3.638257575757576,-1.0549242424242427,-6.331439393939391
2016,137,3280,60,3151,50,H,0,10,5,12,-7,-1,-10,7,-3.19230769230769,-10.603479853479847,-0.23855311355311315,-1.6675824175824197,-5.351190476190476,-7.354395604395604,-6.169871794871794,1.551282051282051,-1.0641025641025639,0.6185897435897445,-0.895833333333333,1.1788003663003668,-8.446886446886447
2016,137,3326,88,3138,69,H,0,19,3,14,-11,-1,-19,11,-8.377747252747255,-6.138003663003673,-2.135531135531136,-2.978708791208792,-4.438141025641023,-3.3916208791208753,3.3022893772893767,-0.6414835164835146,-1.5496336996336986,1.892948717948716,1.1657051282051274,-1.7026556776556774,2.891071428571429
2016,137,3333,73,3407,31,H,0,42,2,15,-13,1,42,-13,-4.591269841269842,-11.238095238095227,-1.2638888888888893,-3.827380952380949,-6.380952380952383,-8.6984126984127,-2.333333333333332,3.6765873015873005,-0.08531746031746046,-2.869047619047617,-4.761904761904763,1.75,-8.6765873015873
2016,137,3376,77,3239,41,H,0,36,1,16,-15,-1,-36,15,-0.02177419354838861,2.608870967741936,0.20806451612903132,1.6669354838709687,-2.64516129032258,-2.3112903225806463,5.824999999999999,-2.6887096774193537,0.3645161290322587,4.002419354838713,1.9822580645161283,-1.6435483870967742,2.532258064516128
2016,137,3382,65,3329,54,N,0,11,10,7,3,-1,-11,-3,0.9385783298826773,4.671497584541065,-2.0686680469289165,-4.756038647342997,0.024844720496894013,2.7456866804692908,5.933057280883368,-0.5258799171842625,1.5776397515527965,0.837819185645273,1.5055210489993094,0.09178743961352609,0.2712215320910971
2016,137,3393,73,3119,56,H,0,17,4,13,-9,-1,-17,9,1.4849999999999994,-11.463571428571434,-0.3714285714285719,-10.052142857142854,-2.4121428571428574,-3.924999999999999,-6.145000000000001,1.4171428571428564,2.6464285714285722,0.29428571428571537,-4.397142857142858,1.138571428571428,0.5814285714285745
2016,137,3397,59,3453,53,N,0,6,7,10,-3,1,6,-3,0.9908906882591104,3.784557547715437,-3.5597165991902835,-8.070416425679582,3.0673076923076934,3.1526894158473127,2.8564921920185107,3.155436668594561,-0.6247108155002898,1.9566223250433765,-0.06203007518796966,2.1607865818392136,0.07157316367842981
2016,137,3452,74,3343,65,N,0,9,6,11,-5,-1,-9,5,1.5911231884057955,2.3368961352656967,0.18218599033816396,-2.366968599033818,2.271920289855071,1.7316425120772934,1.6884661835748798,2.3666666666666636,2.2226449275362317,-1.3475241545893724,-0.5783816425120776,-2.8089371980676328,-0.4339371980676354
2016,138,3163,101,3352,49,H,0,52,1,16,-15,1,52,-15,11.878837719298247,6.262061403508774,0.9901315789473681,0.2083333333333357,1.3892543859649127,-0.4632675438596472,-0.682017543859649,5.00986842105263,9.192982456140351,-3.8240131578947363,4.678728070175438,3.224780701754386,-9.774122807017545
2016,138,3182,97,3371,76,N,0,21,9,8,1,1,21,1,-1.6125836120401367,-0.3404682274247506,1.1353678929765882,2.3988294314381307,-0.5289715719063537,-1.383152173913043,-0.05246655518394583,0.6867474916387906,3.6958193979933114,0.22416387959866135,-1.0346571906354516,-0.36132943143812657,-1.903010033444815
2016,138,3199,72,3292,55,N,0,17,5,12,-7,1,17,-7,4.435559006211179,4.492365424430645,-1.407738095238095,-6.442417184265013,-2.8936335403726705,-3.0570652173913047,2.750258799171842,0.9343944099378874,1.5894151138716364,1.7691511387163565,0.7769151138716381,-0.6561853002070395,-3.2600931677018643
2016,138,3231,62,3208,58,N,0,4,9,8,1,-1,-4,-1,-2.825974025974027,-0.6309163059163012,0.04025974025974044,0.6072871572871534,-4.754256854256855,-5.095021645021646,2.453030303030305,-1.1330086580086558,0.612337662337664,1.862914862914863,0.9166305916305921,0.13290043290043307,4.888419913419913
2016,138,3246,85,3421,31,H,0,54,3,14,-11,1,54,-11,5.281832298136646,3.278467908902691,-1.2589285714285712,-6.508152173913043,-0.6224120082815734,-2.0486542443064195,-2.1119306418219477,1.22942546583851,3.5067287784679095,2.077122153209107,-0.05150103519668736,0.8174171842650102,1.974378881987576
2016,138,3268,74,3233,58,H,0,16,2,15,-13,-1,-16,13,-10.023122529644272,-5.723847167325431,-0.5501976284584984,3.3811594202898547,0.2967720685111992,0.13346508563899917,-0.7699604743083004,-4.369894598155469,-6.668708827404476,-1.952766798418974,1.075757575757577,-1.2797760210803686,2.8979578392621903
2016,138,3281,78,3140,69,N,0,9,10,7,3,-1,-9,-3,0.43603174603174466,1.3919047619047618,-0.5806349206349211,-4.375079365079365,0.47396825396825193,2.419841269841271,-0.16047619047618866,-0.7382539682539644,-0.010476190476190084,-1.7982539682539667,2.0134920634920643,-1.0822222222222222,-1.5519047619047655
2016,138,3323,95,3299,61,H,0,34,1,16,-15,-1,-34,15,-8.20363981369674,-1.7896325685699424,-4.149215111264446,-0.041918233569088414,1.0854752458168022,2.2268414697257217,3.612385716750042,1.3469898223218912,-4.430136277384857,0.5761600828014508,-2.222442642746249,-1.868725202691047,0.5527859237536639
2016,138,3328,61,3345,45,N,0,16,6,11,-5,1,16,-5,-0.16861471861471955,1.8341991341991317,1.30487012987013,6.23733766233766,0.9930735930735928,2.4775974025974037,-0.2257575757575765,2.5888528138528137,-1.6931818181818183,1.7097402597402578,-0.49891774891774965,-1.9377705627705621,2.491883116883116
2016,138,3355,74,3274,71,N,0,3,12,5,7,-1,-3,-7,1.23076923076923,0.1971153846153797,-1.1426282051282044,-3.3445512820512846,-0.1474358974358978,1.467948717948719,1.075320512820511,-0.5576923076923066,1.1522435897435912,3.5576923076923084,1.6041666666666679,-0.740384615384615,1.8028846153846132
2016,138,3378,48,3161,45,N,0,3,6,11,-5,-1,-3,5,-2.7481259370314817,1.1443444944194567,0.08928868898883824,6.05405630518074,-6.801849075462269,-7.177577877727803,0.6394302848575713,0.33008495752124034,-1.4546893220056631,-3.6997334666000334,0.9080459770114935,-1.452440446443445,-1.8191737464601037
2016,138,3390,85,3362,58,H,0,27,4,13,-9,-1,-27,9,1.5239234449760772,0.8505781499202598,0.3598200045568465,-0.09429824561403422,3.862226589200274,3.891518569150147,-1.6213972431077686,0.10490715424925767,0.7636278195488728,2.6462605377079047,1.0249914559125086,-2.824803485987697,4.842432786511736
2016,138,3400,86,3106,42,H,0,44,2,15,-13,-1,-44,13,-3.227453102453101,-5.859126984126988,0.3405483405483407,3.45851370851371,2.2103174603174605,3.6636002886002856,0.10822510822510978,1.9410173160173159,0.2350288600288586,3.517496392496394,-0.06439393939393945,-0.383297258297258,2.3223304473304474
2016,138,3401,74,3283,65,H,0,9,4,13,-9,-1,-9,9,-3.2864044168392006,-0.07453416149067493,3.4033816425120778,11.132505175983436,1.471359558316081,2.0365769496204287,0.491373360938578,-0.2739820565907536,-3.795376121463079,-0.36438923395445144,0.09868875086266371,-0.45169082125603843,-1.0289855072463752
2016,138,3417,66,3218,50,H,0,16,3,14,-11,-1,-16,11,-4.773214285714289,-13.436309523809527,0.4172619047619044,2.0315476190476183,-0.3452380952380949,-0.7339285714285708,-2.2142857142857135,1.119642857142857,0.5232142857142854,2.902976190476192,-5.6053571428571445,-1.7309523809523801,-2.042261904761901
2016,138,3449,65,3335,53,N,0,12,7,10,-3,-1,-12,3,-3.0078063241106747,-2.249703557312259,-1.1047430830039522,-2.3793478260869563,-5.2199604743083,-4.608102766798419,1.0446640316205542,-2.7167984189723313,1.420355731225298,-1.7294466403162065,-0.5014822134387353,2.3689723320158103,-2.641205533596839
2016,139,3124,84,3120,52,H,0,32,1,9,-8,-1,-32,8,-0.9011164274322141,-2.3397129186602825,0.17842902711323738,3.0889154704944204,-0.3078149920255182,1.4451754385964897,-1.689194577352474,-5.951355661881976,-1.5117623604465713,1.5348883572567793,1.4342105263157912,-3.1945773524720886,3.873604465709729
2016,139,3177,73,3257,72,A,0,1,6,3,3,1,1,3,4.648214285714285,5.6878571428571405,3.272142857142857,7.912142857142861,-3.575000000000001,-5.362857142857145,-2.2439285714285724,1.0078571428571408,4.675714285714285,-1.992857142857142,-0.3017857142857139,-0.15107142857142897,-2.625714285714288
2016,139,3280,74,3277,72,A,0,2,5,4,1,-1,-2,-1,3.795787545787544,0.554258241758248,1.2168040293040292,2.391941391941387,1.041666666666666,0.4283424908424891,-1.5478479853479854,4.777472527472526,3.52220695970696,3.4310897435897445,1.0863095238095246,-1.026556776556776,1.431089743589741
2016,139,3326,88,3452,81,H,0,7,3,6,-3,1,7,-3,6.19345238095238,9.207341269841272,2.2728174603174605,3.658730158730158,3.0416666666666643,1.5644841269841265,-1.504960317460318,-1.172619047619051,1.3422619047619033,-2.506944444444443,0.8402777777777786,-1.587301587301587,-1.9771825396825449
2016,139,3333,69,3382,40,H,0,29,2,10,-8,1,29,-8,0.6389751552795033,3.3540372670807486,0.5186335403726705,0.9860248447204967,-1.100155279503106,-1.6630434782608674,5.440993788819876,1.1645962732919273,-0.8152173913043477,0.58385093167702,-1.5163043478260878,0.9052795031055894,-3.062111801242235
2016,139,3376,73,3243,47,H,0,26,1,9,-8,-1,-26,8,-0.29121863799283076,1.4560931899641574,2.6886200716845874,8.353046594982079,-2.2423835125448015,-2.6196236559139834,-0.08333333333333215,-3.00537634408602,3.5367383512544794,0.5663082437275992,1.5878136200716844,-0.610215053763441,-0.0788530465949826
2016,139,3393,76,3107,59,H,0,17,4,12,-8,-1,-17,8,1.1020634920634933,-15.253915343915352,-5.206746031746032,-19.878862433862434,1.3993650793650794,0.47976190476190794,-6.017354497354498,0.6889682539682518,2.890476190476191,0.7777513227513246,-1.6431746031746037,-2.3336507936507944,-1.310105820105818
2016,139,3397,75,3113,64,A,0,11,7,2,5,-1,-11,-5,-1.4942240215924443,-2.6250337381916324,0.8230499325236171,1.6823211875843462,-0.788974358974361,-1.6088798920377876,-1.5305398110661272,-3.3606747638326553,1.0920917678812412,-1.6637651821862338,-0.5270175438596478,-2.0436437246963566,-0.5306207827260465
2016,140,3163,97,3182,51,H,0,46,1,9,-8,1,46,-8,10.051442307692309,2.0605769230769226,0.008653846153846345,-2.1923076923076934,0.07788461538461533,-1.28125,-0.04807692307692335,1.6067307692307722,6.809615384615384,-2.366826923076923,5.4259615384615385,2.279807692307692,-5.673076923076923
2016,140,3199,74,3401,56,A,0,18,5,4,1,1,18,1,-0.37198067632850496,-1.1911663216011021,2.2936507936507935,5.643892339544513,-0.7091097308488603,0.2732919254658377,2.276052449965494,-0.3761214630779861,0.018978605935128456,4.412008281573499,0.6062801932367172,-1.4547964113181502,-0.8295376121463072
2016,140,3246,79,3328,58,H,0,21,3,6,-3,1,21,-3,2.966356107660456,-0.14057971014492665,-2.0285714285714285,-8.267080745341612,-0.6783643892339555,-1.28913043478261,0.5589026915113866,-0.5628364389233944,-0.25993788819875796,0.42950310559006155,-1.666977225672877,0.12753623188405738,0.3279503105590038
2016,140,3323,87,3231,70,H,0,17,1,9,-8,-1,-17,8,-4.826099706744863,-1.9271994134897312,-4.157771260997066,-0.6523460410557185,4.611143695014665,5.323900293255134,0.22976539589442702,3.0439149560117293,-2.9763929618768348,-2.8035190615835788,-1.8308651026392972,-0.060703812316715844,-2.922214076246334
2016,140,3390,66,3355,65,H,0,1,4,12,-8,-1,-1,8,2.01923076923077,3.5528846153846203,1.3360805860805858,3.9070512820512846,-0.8495879120879124,-1.7953296703296715,-1.6824633699633686,-0.24290293040293065,-0.5629578754578759,-1.084478021978022,0.6517857142857144,-1.6256868131868139,1.6078296703296715
2016,140,3400,73,3281,55,H,0,18,2,10,-8,-1,-18,8,-1.8472222222222214,-6.3988095238095255,2.5515873015873014,8.50793650793651,-0.1825396825396819,-2.073412698412703,-1.595238095238095,0.29563492063491736,2.458333333333332,2.200396825396826,-0.5218253968253972,-1.8075396825396823,-0.1607142857142847
2016,140,3417,72,3378,67,H,0,5,3,6,-3,-1,-5,3,-1.9882246376811636,-6.61201690821256,2.3439009661835755,4.680857487922708,-0.5688405797101446,-3.1579106280193265,-3.257246376811594,2.1893115942028984,0.5703502415458921,-0.4073067632850229,-4.145833333333334,-1.6280193236714968,-5.302234299516906
2016,140,3449,74,3268,65,A,0,9,7,2,5,-1,-9,-5,8.545454545454547,6.015151515151516,-0.009090909090908816,-3.7333333333333307,-4.792424242424243,-3.703030303030303,4.927272727272728,0.24696969696969973,7.801515151515151,5.522727272727273,0.17424242424242387,0.5696969696969698,1.2439393939393923
2016,144,3390,90,3323,84,N,0,6,4,1,3,-1,-6,-3,7.58064516129032,4.265456989247312,3.2008448540706596,-1.2029569892473084,-0.5642281105990783,-0.4967357910906305,-2.269105222734254,-2.4376920122887853,2.962269585253459,2.5646121351766507,1.7485599078341023,-2.2894585253456223,3.4355798771121364
2016,144,3393,80,3376,72,N,0,8,4,1,3,-1,-8,-3,-1.3289400921658974,-14.358156682027655,-3.700921658986175,-15.347649769585253,2.822304147465438,3.43271889400922,-8.091428571428573,6.041566820276493,-1.007373271889401,0.18829493087557658,-4.2865437788018435,0.5821198156682019,-2.629400921658984
2016,144,3397,78,3326,62,N,0,16,7,3,4,-1,-16,-4,6.348395026026605,6.280918642760753,4.339478503952188,8.400773568536728,2.7035256410256387,1.9633820127241144,-3.404111239637558,-0.17329381145170686,1.6485203393098118,-1.6470985155195663,-0.20285087719298112,0.47016579911316736,-0.09835887796414511
2016,144,3449,85,3246,72,N,0,13,7,3,4,-1,-13,-4,3.5022868435911896,0.6936194240542051,-2.9805194805194803,-9.395652173913042,-0.7898362507058163,0.7816487859966124,3.0695087521174482,-3.044438170525126,2.108243929983061,4.166516092603047,-0.2522586109542635,-0.36705251270468686,4.626651609260303
2016,145,3124,78,3199,58,N,0,20,1,5,-4,1,20,-4,-2.628740824392999,-1.0397139092791292,-0.8441558441558437,-1.862507058159233,-2.208639186900056,-4.130434782608695,-1.004046677959721,3.200075287031808,-0.7541878411443648,-2.4509693205345364,-0.02691511387163814,3.7224731789949175,-2.220967438358741
2016,145,3163,98,3280,38,N,0,60,1,5,-4,1,60,-4,11.22287087912088,3.429258241758248,3.175137362637363,4.725274725274723,-1.6875,-3.707074175824175,-2.9436813186813175,5.964972527472526,10.001373626373626,-2.7668269230769234,5.294642857142858,1.5776098901098905,-8.923076923076923
2016,145,3333,83,3177,71,N,0,12,2,6,-4,-1,-12,4,6.853214285714284,9.496428571428567,2.795,7.010714285714286,0.5042857142857144,1.072857142857142,0.04749999999999943,-5.61214285714286,6.571428571428571,-2.8842857142857152,3.64607142857143,-2.5925000000000002,2.3171428571428585
2016,145,3400,72,3417,64,N,0,8,2,3,-1,1,8,-1,-3.0029761904761934,-8.50892857142857,-0.1517857142857144,-0.5803571428571423,-0.8214285714285712,-1.342261904761905,-3.2976190476190474,0.6517857142857153,0.0029761904761897995,1.7470238095238102,-2.854166666666668,0.5297619047619051,0.985119047619051
2016,146,3393,89,3397,67,N,0,22,4,7,-3,1,22,-3,0.18482359745517485,7.732585309427421,4.252573742047426,13.854702139965298,-0.8694505494505513,-0.06697513013302725,2.324222093695777,-3.5368652400231326,-0.7717177559282824,-1.6794794679005207,3.2806015037593994,0.30778484673221573,0.4898554077501416
2016,146,3449,85,3390,76,N,0,9,7,4,3,-1,-9,-3,-1.404545454545456,-3.022348484848493,-0.7067099567099566,-2.658333333333335,-2.6287337662337666,-1.2589826839826834,3.580248917748918,-2.7857683982683987,2.991396103896104,1.8661796536796533,-0.3108766233766236,2.3274350649350652,0.7207251082251069
2016,147,3163,86,3400,65,N,0,21,1,2,-1,1,21,-1,10.075892857142858,4.633928571428569,3.5267857142857144,7.892857142857142,-1.6160714285714288,-4.584821428571431,0.0892857142857153,1.8482142857142847,9.392857142857142,-3.8616071428571423,5.0625,1.2410714285714288,-9.839285714285715
2016,147,3333,60,3124,57,N,0,3,2,1,1,-1,-3,-1,1.0925324675324646,2.4199134199134136,-2.2727272727272725,-6.873376623376625,0.6120129870129887,1.8928571428571423,1.787878787878789,-1.1601731601731622,0.9274891774891767,0.43722943722943697,4.386904761904761,0.795454545454545,1.2510822510822521
2016,153,3163,80,3333,51,N,0,29,1,2,-1,1,29,-1,11.254464285714285,7.508928571428569,1.5625,1.7857142857142847,2.1517857142857153,2.1116071428571423,-0.625,-0.6696428571428577,8.446428571428571,-4.308035714285715,7.241071428571429,1.1875,-2.3928571428571423
2016,153,3393,80,3449,59,N,0,21,4,7,-3,1,21,-3,0.5211688311688292,9.456103896103897,1.0337662337662339,7.405714285714286,-2.886233766233767,-0.6077922077922082,7.918701298701301,-6.039220779220777,0.9610389610389625,1.8070129870129854,4.595194805194805,1.1977922077922085,3.6244155844155834
2016,155,3163,82,3393,51,N,0,31,1,4,-3,1,31,-3,9.918035714285715,-3.936785714285719,-0.38035714285714306,-7.855714285714285,0.48964285714285793,-2.5098214285714278,-4.7164285714285725,5.890357142857141,9.682142857142857,-2.7280357142857135,0.43321428571428555,1.826071428571428,-6.847142857142856
2017,137,3113,73,3277,61,N,0,12,8,9,-1,1,12,-1,-3.766490088858511,-5.67691957165642,-4.359734563681933,-9.955143540669855,1.5624003189792646,3.430906812485759,2.2425951241740716,-4.511449077238552,-4.2446741854636585,-1.3677090453406215,0.9586181362497159,-0.2879642287537023,-5.06259968102073
2017,137,3166,76,3405,49,N,0,27,7,10,-3,1,27,-3,-1.1656314699792958,-3.850931677018636,1.912655279503106,3.5304089026915086,-3.5780279503105596,-7.174818840579707,-1.8994565217391308,0.6418219461697703,-0.06599378881987583,-3.5185041407867494,-4.4985766045548665,1.9768374741200834,-5.902562111801242
2017,137,3177,88,3320,67,N,0,21,7,10,-3,1,21,-3,7.089255852842808,9.543328953655042,1.4555661729574778,2.2027293358815108,-2.0685618729096973,-2.326355709507885,1.2838927376970872,2.311335403726705,4.553213091256568,1.7576445293836596,0.5446428571428577,0.5774904443382711,1.7179885332059257
2017,137,3199,87,3442,66,H,0,21,3,14,-11,1,21,-11,2.480833333333333,1.534166666666664,-3.1133333333333315,-10.904166666666665,-0.1850000000000005,0.6999999999999993,3.2633333333333336,0.10333333333333528,-2.3133333333333326,0.778333333333336,-1.7208333333333332,-0.5666666666666664,0.7424999999999997
2017,137,3246,73,3125,70,H,0,3,4,13,-9,-1,-3,9,-0.04230769230769127,2.670879120879114,3.1280219780219776,8.088095238095239,-2.63040293040293,-2.194871794871794,3.5272893772893763,4.097619047619048,3.910256410256409,2.7245421245421237,-2.0609890109890117,1.5890109890109887,-1.5298534798534806
2017,137,3268,103,3137,61,H,0,42,3,14,-11,-1,-42,11,-12.277777777777779,-18.644444444444446,-1.0092592592592586,-1.7796296296296283,-0.4092592592592599,-1.3055555555555536,-6.775925925925927,2.151851851851852,-6.6314814814814795,2.7370370370370374,-3.3240740740740726,-0.7018518518518517,-3.0925925925925952
2017,137,3280,110,3407,69,H,0,41,2,15,-13,1,41,-13,-2.059482758620689,-12.067241379310346,-2.4275862068965512,-9.979310344827589,-2.1775862068965512,-2.3370689655172434,-5.843965517241378,-8.15603448275862,-0.8215517241379295,-6.932758620689654,-1.990517241379309,1.162068965517241,-3.905172413793103
2017,137,3281,66,3378,64,N,0,2,6,11,-5,1,2,-5,-2.3392857142857117,-8.848809523809521,0.7136904761904752,0.017857142857145902,2.5005952380952365,1.8053571428571455,-4.232738095238098,0.12916666666666998,0.6851190476190467,2.7535714285714263,2.2714285714285705,0.679761904761905,5.916666666666668
2017,137,3301,62,3120,48,N,0,14,6,11,-5,-1,-14,5,-1.678475935828878,0.4704449961802908,-1.542971734148205,-2.973500763941942,-1.5598739495798313,-2.78122612681436,0.7864304812834213,-6.019480519480524,-2.2379201680672267,0.1838235294117645,4.087614591291063,-0.0017188693659280219,-0.27310924369747624
2017,137,3323,79,3352,49,H,0,30,1,16,-15,1,30,-15,6.402380952380955,5.602380952380955,-0.9738095238095239,-4.785714285714288,-1.0666666666666664,-1.1619047619047613,1.0500000000000007,1.2023809523809526,3.552380952380952,-3.130952380952383,-0.492857142857142,0.8166666666666664,-3.4166666666666643
2017,137,3326,70,3443,63,N,0,7,5,12,-7,1,7,-7,3.3767806267806257,6.816239316239319,0.27421652421652354,0.7891737891737876,1.5249287749287745,4.761396011396009,0.2044159544159534,5.938034188034187,0.5099715099715123,1.98076923076923,-1.4230769230769251,2.8675213675213675,2.8746438746438727
2017,137,3333,56,3253,55,H,0,1,2,15,-13,-1,-1,13,0.3666144200626995,6.451175548589333,1.6352664576802507,6.534952978056424,0.6186520376175562,2.7384796238244515,2.457993730407525,-8.505799373040752,-2.6862852664576806,-0.46034482758620676,5.321159874608151,-2.8825235109717875,6.883620689655173
2017,137,3345,74,3453,62,N,0,12,9,8,1,1,12,1,-0.5003367003366996,0.9143939393939391,-3.760185185185186,-9.62289562289562,2.5391414141414153,3.329629629629629,0.009764309764308976,2.1314814814814866,-0.3045454545454547,0.08543771043770931,-1.28577441077441,1.8949494949494956,-1.5817340067340044
2017,137,3376,90,3421,40,H,0,50,1,16,-15,1,50,-15,2.9821428571428577,1.7513227513227534,-0.20370370370370328,1.1997354497354475,2.3201058201058196,1.8458994708994716,-0.6091269841269842,-0.18121693121693383,3.4788359788359795,0.5826719576719555,2.799603174603175,1.7744708994708995,0.818121693121693
2017,137,3400,78,3146,50,H,0,28,3,14,-11,-1,-28,11,-3.736660079051383,-10.10918972332017,-1.008646245059289,-0.5303853754940704,0.08349802371541593,-0.16378458498023818,-5.688735177865613,-2.805830039525688,0.608942687747037,-0.8858695652173907,-2.1516798418972325,-1.928853754940711,-2.98418972332016
2017,137,3452,75,3189,62,N,0,13,6,11,-5,-1,-13,5,-0.9207357859531768,1.6130992196209633,-1.5614269788182833,-1.1543478260869549,-0.5060758082497205,1.8934225195094747,3.5003901895206226,-2.2120958751393545,-2.651226309921963,-0.007190635451500782,0.390078037904126,-1.201672240802675,0.8869565217391298
2017,138,3124,119,3411,30,H,0,89,1,16,-15,1,89,-15,9.51161616161616,11.843434343434346,2.0010101010101007,0.4287878787878796,-0.6065656565656568,-2.5535353535353558,2.5808080808080813,4.362626262626264,8.766161616161614,-6.5000000000000036,-4.217171717171716,3.374242424242423,-2.7217171717171738
2017,138,3143,55,3261,52,N,0,3,9,8,1,1,3,1,2.236308428413693,0.594193963930806,3.5446172248803833,10.858713654766285,-1.6491718807508278,-2.5048767022451237,-1.5765734265734253,6.575809716599192,4.508538829591462,2.094028340080971,-4.397975708502025,1.8769598822230407,-2.753827751196173
2017,138,3163,116,3107,55,H,0,61,1,16,-15,-1,-61,15,-8.06818181818182,-1.7596590909090892,-3.3875,-4.96875,-2.9625000000000004,-1.8340909090909108,3.4272727272727277,-3.9727272727272727,-9.039204545454545,8.009090909090908,-0.06590909090909136,-0.8193181818181818,8.345454545454544
2017,138,3181,94,3214,31,H,0,63,2,15,-13,1,63,-13,3.8120370370370367,-5.015740740740732,-0.3037037037037038,-3.810185185185187,0.09907407407407476,-4.091666666666669,-2.9787037037037027,2.0277777777777786,2.9490740740740744,0.9481481481481495,-0.7694444444444439,1.136111111111111,-4.113888888888891
2017,138,3243,67,3179,54,H,0,13,7,10,-3,-1,-13,3,4.250757575757575,2.619107744107737,2.0404040404040407,7.2904040404040416,-1.0010101010101007,-2.828451178451182,-0.5026094276094284,2.3127946127946117,5.170202020202019,1.4958754208754215,1.404713804713806,-1.5615319865319863,2.7175925925925952
2017,138,3257,82,3151,62,H,0,20,4,13,-9,-1,-20,9,-4.87089947089947,-9.984391534391534,-0.492857142857142,0.8626984126984105,0.17275132275132066,-0.8105820105820101,-2.790476190476191,-2.913756613756618,-3.6108465608465625,-1.4761904761904763,-0.8084656084656077,2.8267195767195763,-8.285185185185185
2017,138,3274,62,3195,60,H,0,2,4,13,-9,-1,-2,9,-1.4492753623188364,1.10507246376811,2.8885869565217392,11.009057971014492,0.25634057971014634,0.0851449275362306,-1.4610507246376798,1.409420289855074,0.2509057971014492,-3.099637681159418,-0.704710144927537,-1.5,-0.8125
2017,138,3328,75,3211,62,N,0,13,6,11,-5,-1,-13,5,-0.4417249417249387,-4.349456099456091,-0.9063714063714059,-0.17055167055167075,0.4009324009324011,-0.35198135198135105,1.1225718725718714,-0.6594794094794096,2.004467754467754,-1.2546620046620038,-1.3834498834498836,-0.32303807303807197,-1.3142968142968137
2017,138,3332,71,3396,70,N,0,1,10,7,3,1,1,3,2.3013278388278415,-5.197847985347977,-1.1423534798534796,-7.3239010989011,-0.9536172161172161,-1.542811355311354,-3.603708791208792,-0.1286630036630072,2.395833333333332,-0.43585164835164747,0.22967032967032974,-0.07843406593406588,-0.9817765567765555
2017,138,3346,68,3266,65,N,0,3,12,5,7,-1,-3,-7,5.607089947089946,1.3584126984126925,-0.1148148148148147,-3.665767195767195,0.11047619047618795,-0.5878835978835966,-1.0950264550264546,0.7609523809523786,0.5123809523809548,-3.202063492063493,-3.6907936507936494,-2.5143915343915344,-5.914920634920637
2017,138,3390,72,3308,64,N,0,8,2,15,-13,-1,-8,13,-2.77034632034632,-3.0310606060606062,0.9732683982683978,2.660281385281385,-0.8810606060606059,-1.6997835497835503,-1.3522727272727266,-1.7332251082251062,-1.1803030303030315,3.520670995670997,1.853138528138528,-1.0694805194805195,4.031168831168831
2017,138,3393,85,3235,65,N,0,20,8,9,-1,-1,-20,1,-1.3623015873015873,-6.731349206349208,-0.995634920634922,-6.218650793650795,0.1003968253968246,-1.080158730158729,-4.467460317460315,3.8317460317460323,0.3662698412698422,-1.7166666666666668,-3.963095238095238,-0.7900793650793645,-0.5281746031746053
2017,138,3397,66,3173,57,N,0,9,5,12,-7,-1,-9,7,-4.120946305156828,-5.142211589580015,1.7983785220627322,4.827884104199892,-1.7044125465178102,-0.3257575757575779,0.8411749069643797,-1.2854864433811812,-1.4312865497076022,2.059144072301965,-0.8333333333333339,0.9988038277511961,4.030170122275386
2017,138,3401,63,3335,61,N,0,2,5,12,-7,-1,-2,7,-3.8636363636363633,0.06926406926407225,2.2813852813852806,9.406926406926406,-4.5995670995671,-4.277056277056275,1.0930735930735924,-0.1212121212121211,-1.6103896103896105,-2.2813852813852833,0.11255411255411207,3.0476190476190474,-2.5021645021645007
2017,138,3417,83,3129,56,H,0,27,4,13,-9,-1,-27,9,-0.9774844720496922,-3.8249223602484506,1.0232919254658386,1.4642857142857153,-4.093167701863354,-6.0819099378882004,-1.4856366459627335,-0.9611801242236027,1.1944875776397534,3.7026397515527947,-1.5252329192546572,-1.9239130434782612,-0.479037267080745
2017,138,3449,91,3286,63,H,0,28,3,14,-11,-1,-28,11,-3.1193236714975825,2.4273752012882426,-2.4421900161030585,-2.212640901771337,-1.6832528180354274,-1.4264895330112708,3.7005636070853445,-0.3716586151368766,1.8857487922705314,5.005716586151369,1.0165861513687604,0.765297906602254,5.744685990338164
2017,139,3199,77,3281,55,H,0,22,3,6,-3,1,22,-3,5.257619047619048,13.237142857142857,-1.3895238095238085,-3.526190476190475,0.08523809523809689,2.2904761904761877,6.2252380952380975,-2.7133333333333347,0.022380952380952834,-2.558571428571426,2.8619047619047624,0.2952380952380955,-1.2366666666666646
2017,139,3268,83,3452,56,H,0,27,3,6,-3,1,27,-3,7.503623188405797,9.55797101449275,0.07318840579710084,1.4123188405797116,0.5028985507246393,1.1485507246376798,5.497826086956522,-1.415942028985505,3.0449275362318815,-1.7956521739130409,0.402898550724637,-0.8144927536231883,0.10362318840579832
2017,139,3280,92,3177,71,H,0,21,2,7,-5,-1,-21,5,4.12102122015915,11.128505115574086,4.114674118984464,13.530409245926489,-3.730106100795755,-4.4126563092080335,1.6870973853732476,4.573891625615762,4.667156119742325,1.1860553239863574,0.6976600985221681,-0.35794808639636155,-2.1648825312618385
2017,139,3323,88,3345,82,H,1,6,1,9,-8,1,6,-8,4.565151515151516,3.635606060606065,0.625,-0.7530303030303038,-2.611363636363638,-2.6999999999999993,-0.05606060606060481,-0.5166666666666693,1.704545454545455,-0.8946969696969695,0.0931818181818187,-0.9727272727272736,2.278030303030304
2017,139,3326,82,3246,68,A,0,14,5,4,1,-1,-14,-1,-3.956410256410255,-8.533699633699626,-2.022893772893773,-5.695787545787546,-0.8849816849816854,-3.6743589743589737,-2.714468864468863,-3.6078754578754584,-1.76923076923077,-1.6950549450549453,-0.5364468864468854,-4.099267399267399,-3.8368131868131865
2017,139,3333,64,3166,52,H,0,12,2,7,-5,-1,-12,5,0.5297708288712819,2.877516598843428,0.8286035553651754,3.3271043049903604,-0.27414863996573224,-1.4844452773613188,-0.4835082458770614,-1.3351895480831004,0.14090276290426296,-1.1830156350396237,0.4676590276290433,-0.6143981580638256,1.543558577853931
2017,139,3376,71,3113,68,H,0,3,1,8,-7,-1,-3,7,-2.7558479532163744,-1.5209551656920084,-1.6069688109161797,-5.305311890838205,-1.5748050682261212,-1.7692495126705658,1.360380116959064,-0.8075048732943451,0.08601364522417043,0.9410331384015613,-0.5336257309941521,-1.5389863547758287,-0.40813840155945336
2017,139,3400,84,3301,80,H,0,4,3,6,-3,-1,-4,3,-3.8502964426877426,-5.387598814229257,3.195899209486166,11.088932806324113,2.663043478260869,3.74530632411067,-3.6489624505928866,-0.3058300395256879,1.4782608695652186,-2.2608695652173907,-0.04372529644268752,-2.542490118577075,-1.5978260869565233
2017,140,3124,86,3143,46,H,0,40,1,9,-8,1,40,-8,4.043994601889338,6.665654520917684,1.356140350877192,-1.3882591093117398,1.8900809716599198,2.380634278002699,4.403846153846153,3.44919028340081,2.923279352226718,-2.3356950067476383,-1.9186909581646416,2.354858299595141,0.9280701754385952
2017,140,3163,94,3393,64,H,0,30,1,8,-7,1,30,-7,5.9571428571428555,-6.5264880952380935,-0.9886904761904773,-9.694345238095238,-0.4482142857142861,-1.5523809523809504,-4.9952380952380935,5.109523809523811,8.946130952380953,-1.7583333333333329,0.07857142857142918,0.8279761904761909,-5.430952380952384
2017,140,3257,75,3397,64,H,0,11,4,5,-1,1,11,-1,0.998582314371788,0.8582694109009879,2.0880610617452717,5.358547884863675,-4.383585225690489,-4.818422318422321,1.2527910685805423,-2.9552796131743477,0.9733551049340541,0.8033720665299597,0.7491582491582482,-1.0032404242930562,3.538226880332143
2017,140,3332,74,3181,65,A,0,9,10,2,8,-1,-9,-8,-1.548219373219375,-1.9875356125356092,-1.1024216524216524,-0.4922364672364665,1.9830484330484328,1.849358974358971,0.26488603988604,-0.47927350427350035,-2.325925925925926,2.200071225071225,2.9318376068376075,2.3258547008547006,-0.5106837606837615
2017,140,3346,85,3274,78,A,0,7,12,4,8,-1,-7,-8,3.238627214170691,-2.4661835748792242,-0.14090177133655413,-4.198872785829309,-1.2563405797101463,-1.0342190016103032,-1.1130233494363928,-2.346920289855074,-0.7300724637681135,0.9885265700483075,-1.1216787439613523,-1.3379629629629628,-2.0902777777777786
2017,140,3390,69,3243,48,A,0,21,2,7,-5,-1,-21,5,-1.8733766233766218,-3.74318181818181,0.6853896103896098,1.3496753246753226,1.920454545454545,2.6850649350649363,-2.5159090909090907,-1.9483766233766247,0.290909090909091,1.6237012987012989,0.7152597402597394,-0.5512987012987018,0.235714285714284
2017,140,3417,75,3401,43,H,0,32,4,5,-1,-1,-32,1,-1.1852766798418983,-10.757540466779595,-1.8543666478449081,-10.728354978354979,-0.0008469791078482558,-1.402162149444763,-1.7484824957651046,-0.754046677959721,1.4384175607001701,3.5357848673066066,-3.195758046301524,-2.14648033126294,-1.4313241106719374
2017,140,3449,108,3328,82,H,0,26,3,6,-3,-1,-26,3,-1.9510101010101017,2.3612794612794517,-2.8382154882154875,-4.784006734006734,-0.035690235690235994,0.2526936026936042,2.6097643097643086,-4.212457912457914,0.6181818181818173,5.293265993265994,3.2553872053872057,2.539562289562289,3.2429292929292917
2017,144,3124,97,3257,63,N,0,34,1,4,-3,1,34,-3,3.0814814814814824,1.57275132275133,-0.5285714285714285,-5.096825396825398,2.658465608465608,4.444179894179893,2.083333333333332,4.307671957671957,3.3034391534391503,-0.5119047619047628,-1.6203703703703694,3.8838624338624332,-1.8661375661375672
2017,144,3280,75,3449,64,N,0,11,2,3,-1,1,11,-1,-1.4817049808429132,-1.149648786717762,-4.543326947637292,-10.077458492975737,-1.507215836526182,-1.1472541507024268,3.4069604086845455,-8.61066411238825,1.222892720306513,2.1968710089399757,1.089112388250319,1.6074393358876113,4.7253831417624514
2017,144,3323,99,3326,76,N,0,23,1,5,-4,1,23,-4,-0.28974358974358694,-7.005128205128202,-1.7371794871794872,-9.007692307692306,-6.356410256410257,-8.924358974358974,-2.3025641025641015,-3.0935897435897424,3.314102564102562,-0.4474358974358985,0.9064102564102576,-2.4564102564102566,-2.4320512820512796
2017,144,3390,77,3400,66,N,0,11,2,3,-1,1,11,-1,-2.6291925465838517,-3.6728260869565332,0.8741459627329196,3.8131211180124236,1.3130434782608695,1.994332298136646,-2.2228260869565233,1.192546583850934,0.690760869565219,-2.482298136645962,0.10124223602484506,-0.336645962732919,-5.333540372670807
2017,145,3163,86,3417,71,H,0,15,1,4,-3,1,15,-3,6.701086956521738,-5.398097826086953,2.078804347826087,-1.15625,-0.508152173913043,-2.5244565217391326,-3.024456521739131,2.8152173913043477,9.74320652173913,1.141304347826086,0.40489130434782616,0.10054347826086918,-5.885869565217391
2017,145,3199,66,3333,53,N,0,13,3,2,1,1,13,1,5.072068965517243,10.075114942528728,-0.67655172413793,-1.690804597701149,3.014712643678161,3.9112068965517235,3.950114942528737,-4.790344827586207,-1.2314367816091938,-0.32367816091953827,5.078735632183909,-1.5537356321839084,4.146954022988508
2017,145,3332,77,3268,63,N,0,14,10,3,7,-1,-14,-7,7.014743589743588,10.553205128205121,1.1512820512820507,6.176282051282051,2.7256410256410266,4.0660256410256395,6.051923076923078,0.37628205128205394,2.0166666666666657,0.5519230769230763,1.1929487179487168,1.7314102564102565,1.4782051282051292
2017,145,3376,100,3346,58,N,0,42,1,12,-11,-1,-42,11,-3.2546296296296298,5.212962962962962,1.2407407407407405,6.305555555555557,-1.879629629629628,-2.625,1.087962962962962,1.4074074074074119,0.9259259259259238,0.9490740740740762,2.208333333333332,-0.2361111111111116,5.523148148148149
2017,146,3280,94,3124,85,N,1,9,2,1,1,-1,-9,-1,4.426149425287356,4.55890804597702,1.269252873563218,-0.5706896551724121,0.1275862068965523,1.078735632183907,2.568965517241379,8.53103448275862,5.171551724137929,0.816091954022987,-2.0761494252873556,2.712931034482758,-3.4364942528735654
2017,146,3390,76,3323,75,N,0,1,2,1,1,-1,-1,-1,3.8023809523809575,0.5250000000000057,0.2535714285714281,-2.2821428571428566,-2.958333333333334,-3.9452380952380963,-2.0749999999999993,-1.7726190476190489,3.3499999999999996,0.2964285714285708,0.5107142857142861,-0.9285714285714288,1.8357142857142854
2017,147,3163,90,3332,52,H,0,38,1,10,-9,1,38,-9,6.398076923076921,3.2052884615384585,2.1721153846153847,5.453365384615385,2.4298076923076923,1.9326923076923066,-0.04807692307692335,2.509615384615387,7.34375,-1.8230769230769237,3.3596153846153847,2.185576923076923,-4.988461538461539
2017,147,3376,71,3199,64,N,0,7,1,3,-2,-1,-7,2,1.9738888888888901,7.115185185185183,0.39592592592592624,-0.6425925925925888,-0.7729629629629624,-1.4157407407407412,2.693888888888889,-0.40592592592592425,0.2792592592592591,-0.09203703703703425,1.2027777777777775,-1.2657407407407408,1.2587037037037057
2017,151,3280,66,3163,64,N,1,2,2,1,1,-1,-2,-1,6.90948275862069,2.3609913793103487,3.1400862068965516,5.223060344827587,0.2650862068965516,-1.387931034482758,-1.431034482758621,6.181034482758619,9.86530172413793,-1.1422413793103452,3.0905172413793105,0.7004310344827589,-7.969827586206897
2017,151,3376,62,3390,53,N,0,9,1,2,-1,1,9,-1,0.3218253968253997,-3.693518518518516,0.07764550264550252,1.0937830687830665,2.2712962962962955,2.5371693121693113,-1.4722222222222214,-2.4133597883597915,-0.24259259259259203,0.9251322751322739,0.624603174603175,-0.029497354497354245,0.9903439153439137
2017,153,3376,67,3280,55,N,0,12,1,2,-1,-1,-12,1,0.1044061302681989,2.6262771392081703,-0.276660280970626,-2.055236270753511,-1.1238825031928474,-1.9778097062579825,0.5282567049808424,-2.606960408684543,0.07104086845466107,-0.8114623243933572,-0.8544061302681998,-0.4620051085568333,3.715197956577267
2018,137,3124,96,3212,46,H,0,50,2,15,-13,1,50,-13,6.674219668277395,5.447694919681339,-1.4448870314744675,-7.144769491968134,0.16083322450045578,-0.5770536763745611,5.8971529319576845,5.926994906621392,5.492947629619955,-2.4740107091550207,-5.91837534282356,0.030886770275564857,-2.39010056157764
2018,137,3177,90,3328,79,N,0,11,5,12,-7,1,11,-7,2.189217032967033,7.564903846153854,4.963942307692307,14.055631868131872,-3.7726648351648358,-6.36710164835165,2.13701923076923,-2.664491758241759,6.728365384615383,-1.1473214285714288,-0.4395604395604398,-2.1164148351648358,0.502060439560438
2018,137,3257,74,3129,42,H,0,32,1,16,-15,-1,-32,15,-1.5798611111111107,-1.6145833333333286,1.5476190476190474,3.1153273809523796,1.917906746031747,2.398313492063492,1.1555059523809526,-3.415674603174601,0.7182539682539684,1.6257440476190474,-1.0200892857142856,0.46825396825396837,1.2189980158730158
2018,137,3266,84,3173,65,N,0,19,8,9,-1,-1,-19,1,-5.2946859903381664,-7.64492753623189,1.1944444444444446,-1.19927536231884,1.1002415458937183,1.1533816425120733,-1.8393719806763276,5.479468599033815,-2.079710144927537,-0.06884057971014457,-4.722222222222222,1.996376811594203,-0.6388888888888928
2018,137,3268,77,3343,57,N,0,20,5,12,-7,1,20,-7,5.930476190476192,9.586904761904762,-0.7448809523809512,-4.003690476190474,2.5584523809523816,5.1295238095238105,3.3495238095238093,0.12726190476190524,1.1102380952380937,-1.3864285714285725,0.9236904761904761,-0.8379761904761902,0.5609523809523793
2018,137,3276,75,3294,61,N,0,14,7,10,-3,1,14,-3,2.7531080031080037,1.3315850815850752,0.14102564102564052,-4.954351204351205,1.789432789432789,3.015345765345767,3.5033022533022518,4.086829836829839,0.2501942501942498,3.060994560994562,-2.417249417249417,-0.2748640248640255,0.13616938616938512
2018,137,3278,89,3453,77,N,0,12,10,7,3,1,12,3,6.555909545227387,13.117316341829081,2.9317841079460276,3.622563718140931,6.465048725637182,7.218890554722638,1.9280359820089945,1.3982696151924046,1.6820652173913047,-0.602542478760622,0.35772738630684664,1.1090392303848073,0.41191904047975925
2018,137,3301,62,3189,35,H,0,27,4,13,-9,-1,-27,9,3.0565476190476204,2.110119047619051,-1.5446428571428568,-4.208333333333332,-0.45238095238095255,-1.0416666666666643,0.3660714285714288,0.3630952380952408,2.157738095238095,2.9107142857142847,2.895833333333332,-0.11607142857142883,2.6369047619047628
2018,137,3323,99,3169,81,H,0,18,1,16,-15,-1,-18,15,-7.920114942528734,-7.165517241379305,0.137931034482758,5.006704980842912,1.6704980842911894,3.583141762452108,0.8400383141762457,5.308429118773947,-1.2934865900383112,3.5174329501915693,-1.6421455938697314,2.2680076628352492,1.0752873563218408
2018,137,3332,88,3370,45,H,0,43,2,15,-13,1,43,-13,3.3615079365079374,-3.529761904761898,1.4746031746031747,0.06388888888889,0.5301587301587283,-0.5357142857142865,-1.4607142857142854,-3.3801587301587332,2.8543650793650777,-0.21230158730158877,-0.37976190476190474,0.9857142857142858,-2.4075396825396815
2018,137,3333,82,3443,58,N,0,24,6,11,-5,1,24,-5,-0.6393633540372683,-7.824145962732921,2.295419254658385,3.7643633540372683,-6.638975155279502,-7.678571428571427,-5.321428571428571,7.479813664596275,5.006211180124222,4.048524844720497,-5.373447204968944,1.5100931677018639,-4.73641304347826
2018,137,3376,63,3299,52,H,0,11,2,15,-13,-1,-11,13,-3.2035256410256387,3.8209706959707006,-0.07257326007326004,3.772664835164834,-1.6801739926739927,-0.1009615384615401,3.678342490842491,0.8003663003663029,0.5844780219780219,4.717261904761905,1.1527014652014653,-2.420558608058608,3.335164835164832
2018,137,3397,100,3251,60,H,0,40,3,14,-11,-1,-40,11,-3.9741161616161627,-7.758477633477639,-0.22032828282828376,-0.7867965367965368,-4.169191919191919,-5.660443722943723,-0.49476911976911886,-4.784451659451662,-2.1446608946608947,0.5227272727272734,0.17243867243867328,-0.5670995670995667,2.2639790764790746
2018,137,3401,89,3179,76,H,0,13,4,13,-9,-1,-13,9,1.765555555555558,0.2200396825396851,4.76968253968254,13.823452380952382,-1.2548809523809528,-1.386626984126984,-2.2606349206349208,-0.3013095238095218,8.269603174603176,2.0649603174603186,2.0037698412698415,-0.12757936507936485,-0.16543650793650855
2018,137,3437,81,3355,74,N,1,7,9,8,1,-1,-7,-1,2.0093181818181804,2.9387878787878776,-0.14893939393939348,-3.7479545454545473,3.6498484848484853,3.999545454545455,3.354772727272728,1.3978030303030273,1.779393939393941,2.997272727272726,2.507575757575757,-0.05553030303030271,2.0859848484848467
2018,137,3438,68,3143,62,N,0,6,10,7,3,-1,-6,-3,2.724114774114774,1.3583028083028097,-1.1450549450549454,-2.307631257631261,0.44774114774114615,1.1416361416361411,0.7184371184371177,-0.050122100122099056,1.8386446886446883,-1.1669108669108645,-1.1214285714285719,-0.9626373626373628,-0.5252136752136742
2018,138,3113,73,3304,62,N,0,11,7,10,-3,1,11,-3,0.2976190476190439,-1.8476190476190482,-3.0785714285714283,-7.502380952380953,0.20238095238095255,-1.3154761904761898,-0.30238095238095397,-3.221428571428575,-1.0488095238095276,-3.43452380952381,-0.6166666666666671,-3.227380952380952,-3.305952380952382
2018,138,3138,102,3378,79,N,0,23,11,6,5,1,23,5,3.0173789173789167,8.219129019129028,-1.6148148148148147,-3.147395197395195,2.0599511599511597,4.524765974765977,2.568111518111518,-0.45468050468050336,3.189295889295888,3.449877899877901,7.8318070818070815,2.591961741961742,7.6897842897842885
2018,138,3141,78,3261,69,N,0,9,11,6,5,1,9,5,2.4865984405458086,-0.15277777777777857,5.635233918128655,12.439327485380115,2.2175925925925934,-0.854775828460042,-0.8114035087719316,4.882797270955166,3.7860623781676406,1.3988791423001956,-4.239766081871345,0.5002436647173489,-3.3160331384015613
2018,138,3163,140,3384,52,H,0,88,1,16,-15,1,88,-15,7.4060990338164245,-5.008001207729478,-1.4666364734299506,-11.461805555555557,-1.035477053140097,-2.4171195652173907,-2.626660628019323,5.780344202898551,7.885869565217391,-4.349637681159422,-1.5951086956521738,0.6875,-7.7664553140096615
2018,138,3166,76,3234,70,N,0,6,11,6,5,1,6,5,-4.82043650793651,-3.6081349206349245,3.978174603174603,8.405753968253972,-3.1676587301587293,-4.12202380952381,-1.6815476190476186,-4.848214285714285,-4.5297619047619015,-4.673611111111111,-1.2113095238095237,-1.7509920634920633,1.6021825396825378
2018,138,3181,72,3125,58,N,0,14,5,12,-7,-1,-14,7,1.763636363636362,5.522348484848479,3.114772727272726,10.978030303030305,1.460606060606061,0.7681818181818176,0.6128787878787865,1.7795454545454525,2.489393939393942,-3.760227272727274,-6.056818181818182,-0.8401515151515149,0.8257575757575779
2018,138,3195,80,3281,70,N,0,10,12,5,7,1,10,7,2.37334656084656,6.051917989417987,3.7777777777777777,12.192460317460316,-1.5396825396825395,-1.0701058201058213,-0.5274470899470902,-5.224206349206348,0.1335978835978846,-2.860449735449736,3.4586640211640214,-2.013558201058201,0.27513227513227534
2018,138,3199,91,3114,49,H,0,42,3,14,-11,-1,-42,11,-6.287294685990339,-11.704009661835741,-4.600917874396135,-10.838550724637678,-1.9093236714975834,-2.9339130434782614,-3.8066666666666684,-2.601304347826087,-2.0539130434782606,1.4330434782608705,-0.17256038647342997,-1.259371980676328,1.3690338164251195
2018,138,3208,68,3273,63,H,0,5,4,13,-9,1,5,-9,-0.3433333333333337,-1.096666666666664,-1.2200000000000002,0.43666666666666565,0.28000000000000114,3.286666666666667,-1.0700000000000003,6.503333333333337,-0.6899999999999977,3.6700000000000017,-1.5766666666666644,2.73,1.4400000000000013
2018,138,3280,95,3311,50,H,0,45,1,16,-15,1,45,-15,3.1454326923076934,4.449519230769226,0.055288461538461675,0.6117788461538467,-2.98076923076923,-4.905048076923077,-1.9795673076923066,-3.1899038461538467,1.021634615384615,-8.639423076923077,-1.86298076923077,0.42307692307692335,-3.34735576923077
2018,138,3326,87,3203,45,H,0,42,3,14,-11,-1,-42,11,-8.849602639076323,-14.637014544909285,-2.4757085020242915,-7.06159094316989,-1.0769980506822616,-2.0730994152046787,-3.3680086969560676,-2.9990253411306043,-0.6739391213075407,0.33966861598440623,-0.44549407707302535,-1.9526540710751243,-2.1372019793072425
2018,138,3329,84,3393,57,N,0,27,9,8,1,1,27,1,1.25,0.9272727272727295,-2.9749999999999996,-10.339772727272724,4.356818181818181,5.8454545454545475,-1.538636363636364,1.6136363636363633,-1.523863636363636,-3.2488636363636374,0.20113636363636367,-0.415909090909091,-1.0295454545454525
2018,138,3346,86,3274,72,N,0,14,9,8,1,-1,-14,-1,2.2796296296296283,-2.402380952380952,-3.1854497354497333,-9.712698412698412,2.427777777777779,3.768253968253969,1.843915343915345,0.6468253968253954,-1.7132275132275119,5.5777777777777775,-0.44576719576719626,-0.9121693121693122,1.25079365079365
2018,138,3390,82,3211,68,H,0,14,4,13,-9,-1,-14,9,-0.9796296296296312,-1.3531986531986533,-2.2818181818181813,-4.462794612794614,4.001178451178452,3.4220538720538727,0.6183501683501671,-4.562794612794612,-0.3749158249158242,-2.5500000000000007,1.938888888888889,-1.450505050505051,-2.824410774410776
2018,138,3400,83,3263,54,H,0,29,2,15,-13,-1,-29,13,-7.380341880341881,-11.311050061050068,2.079365079365079,6.515262515262513,-3.20970695970696,-4.96153846153846,-3.6269841269841265,-1.6776556776556788,-0.9908424908424891,1.8208180708180706,0.7228327228327238,-1.478021978021978,-1.967948717948719
2018,138,3417,71,3110,60,H,0,11,3,14,-11,-1,-11,11,-5.719780219780219,-10.885073260073256,-1.0464743589743595,-2.2023809523809526,-0.4532967032967026,-1.4429945054945073,-7.092032967032967,1.1172161172161168,-2.6174450549450565,0.8621794871794854,-2.582417582417582,-1.2783882783882783,-1.6474358974358978
2018,139,3124,80,3276,58,H,0,22,2,7,-5,1,22,-5,3.7530954708374082,7.80571847507332,-3.1129032258064515,-5.774763766699252,0.5873248615184092,1.7797328119908755,5.9512056044314114,2.676197458455519,3.671228413163897,-1.7047083740632125,-1.2825024437927661,0.5048061257738681,1.372515477354188
2018,139,3257,90,3266,72,H,0,18,1,8,-7,1,18,-7,-3.9708635265700494,-8.45788043478261,-0.9685990338164245,-3.987998188405797,-4.176705917874397,-5.430404589371982,-2.6330766908212553,2.96225845410628,-1.6413043478260878,1.5957880434782616,-3.0675573671497585,0.7608695652173916,-1.9833182367149789
2018,139,3301,74,3268,60,H,0,14,4,5,-1,-1,-14,1,7.0721428571428575,8.11607142857143,-0.1198809523809512,-3.3703571428571415,-0.7748809523809541,-2.4538095238095217,1.8578571428571422,-2.0977380952380926,3.768571428571427,-0.0489285714285721,2.702857142857143,-0.367142857142857,1.0984523809523807
2018,139,3323,98,3437,72,H,0,26,1,9,-8,1,26,-8,6.80609979101358,8.76097178683385,-3.2402037617554846,-11.97577063740857,2.328239289446186,3.0019592476489017,5.71362330198537,-1.3684038662486948,3.2439916405433635,3.537617554858933,3.438610240334378,-0.9890935214211076,-0.47263584117032487
2018,139,3332,101,3278,73,H,0,28,2,10,-8,-1,-28,8,0.602173913043476,10.067028985507235,1.120289855072464,5.042391304347827,2.87481884057971,4.641304347826086,4.327173913043479,2.4534420289855063,-1.342934782608694,-0.04076086956521863,1.9505434782608688,-0.363949275362319,1.9242753623188378
2018,139,3333,66,3397,59,A,0,7,6,3,3,1,7,3,-0.5904503105590067,-6.298395445134581,3.3859989648033118,5.5553830227743255,-6.767598343685299,-9.629528985507246,-3.5898033126293996,1.148809523809522,2.996376811594203,-1.7893374741200816,-3.8690476190476186,1.4704968944099384,-3.2265786749482412
2018,139,3376,66,3438,56,H,0,10,2,10,-8,1,10,-8,3.950854700854702,2.6004273504273527,-1.4230769230769234,-4.021367521367525,4.188034188034187,6.632478632478634,0.7585470085470085,0.3376068376068382,0.16666666666666607,-2.081196581196579,0.6538461538461533,1.852564102564103,0.5491452991453016
2018,139,3401,80,3177,79,H,0,1,4,5,-1,-1,-1,1,2.3028083028083053,6.823336385836399,7.168803418803417,20.204441391941398,-3.9214743589743595,-4.302121489621491,-1.0470085470085486,-2.433836996336993,6.541361416361415,0.46924603174603163,1.321352258852258,-0.7627442002442004,1.5655525030525013
2018,140,3138,86,3199,65,A,0,21,11,3,8,1,21,8,-0.4618518518518542,3.05074074074075,-1.0514814814814812,-0.4362962962962911,1.898888888888889,3.0770370370370372,-0.025185185185184977,0.8307407407407439,2.1792592592592595,2.8755555555555574,6.317777777777778,1.4485185185185188,5.707037037037036
2018,140,3141,95,3326,78,A,0,17,11,3,8,1,17,8,-2.5787037037037024,-9.773148148148152,-0.06944444444444464,-2.449074074074076,1.3101851851851851,0.8148148148148131,0.6851851851851833,1.9861111111111072,1.8611111111111107,4.171296296296298,-3.2592592592592595,-1.1064814814814818,-1.143518518518519
2018,140,3163,71,3346,46,H,0,25,1,9,-8,1,25,-8,11.167129629629628,2.15625,-0.13217592592592453,-5.828472222222221,0.8548611111111111,-0.311805555555555,0.6483796296296305,5.446527777777778,7.687962962962963,-0.11388888888888893,1.006018518518518,1.0467592592592592,-5.688194444444445
2018,140,3181,66,3208,40,A,0,26,5,4,1,1,26,1,-0.4703030303030289,-6.709015151515146,2.155227272727273,1.951969696969698,1.15939393939394,1.1784848484848478,-0.6928787878787865,0.500454545454545,-0.14939393939394208,1.3402272727272724,1.6168181818181804,-1.2731818181818184,-5.049090909090911
2018,140,3280,71,3329,56,H,0,15,1,9,-8,1,15,-8,-1.390625,-3.606250000000003,-1.2125000000000004,-1.6531250000000028,-4.331249999999999,-6.253125000000001,-3.0906249999999993,-4.71875,-0.9875000000000007,-2.8562499999999993,0.9437499999999996,0.3250000000000002,-1.3156250000000007
2018,140,3390,90,3195,70,H,0,20,4,12,-8,-1,-20,8,0.29537037037037095,-2.031902356902357,4.204292929292929,9.863131313131312,0.8752525252525256,-0.40387205387205505,-2.551094276094277,-4.553535353535352,1.7445286195286211,-2.9342592592592602,0.7092592592592597,-3.652356902356903,-0.4864478114478139
2018,140,3400,85,3113,65,H,0,20,2,7,-5,-1,-20,5,-5.1382783882783905,-10.981684981684985,-0.7738095238095237,-3.0045787545787555,-1.3049450549450547,-2.1222527472527464,-3.1428571428571423,-2.2609890109890145,0.25320512820512775,-1.927197802197803,-1.4358974358974361,-1.6982600732600734,-4.711996336996338
2018,140,3417,86,3166,64,H,0,22,3,11,-8,-1,-22,8,-2.8650793650793673,-10.10515873015872,2.7847222222222214,3.7837301587301617,-0.8849206349206344,-2.7827380952380985,-7.595238095238095,2.3928571428571423,1.1101190476190474,0.13888888888888928,-5.095238095238095,-0.32539682539682513,-2.388888888888893
2018,144,3257,86,3390,59,H,0,27,1,4,-3,1,27,-3,0.5187500000000007,-2.246022727272724,-1.2818181818181813,-5.093465909090909,-0.6855113636363637,-2.3471590909090914,-1.444034090909092,-0.5465909090909093,0.5454545454545467,-0.1281250000000007,-0.8156249999999998,-2.2727272727272734,-1.4349431818181841
2018,144,3280,71,3301,57,N,0,14,1,4,-3,1,14,-3,3.109375,2.78125,-0.5416666666666661,-0.640625,-2.510416666666668,-6.119791666666664,-4.640625,-5.697916666666664,0.0625,-5.59375,2.34375,-1.375,-1.1614583333333321
2018,144,3333,72,3124,67,N,0,5,6,2,4,-1,-5,-4,3.9956922460428785,9.29513123622521,-4.519735523943098,-9.856842316169104,5.625125225405729,7.569525145261469,6.844219595271488,0.8894009216589858,0.7574634341815276,0.45331596874374114,1.1958525345622126,-1.4923862953315972,4.007012622720898
2018,144,3417,84,3400,75,N,0,9,3,2,1,-1,-9,-1,2.70970695970696,1.1662087912088026,-0.5208333333333339,-2.138278388278387,-0.004578754578753674,0.012133699633697148,-1.3869047619047628,1.6300366300366314,-0.726419413919416,1.60576923076923,-1.2426739926739927,-0.6053113553113554,0.8846153846153832
2018,145,3163,72,3181,59,N,0,13,1,5,-4,1,13,-4,9.801136363636363,9.161931818181813,2.0085227272727266,3.8551136363636367,1.5710227272727266,0.16193181818181834,-0.20170454545454675,4.798295454545453,8.147727272727273,-3.8352272727272734,0.8806818181818183,0.6306818181818183,-2.68465909090909
2018,145,3323,90,3401,84,N,0,6,1,4,-3,1,6,-3,3.742337164750957,2.5141283524904168,0.7231800766283527,1.3613505747126453,-3.3441091954022983,-3.9456417624521087,-0.978927203065135,-2.5237068965517224,4.235153256704979,-0.11326628352490431,0.7157567049808424,-0.8249521072796937,-3.251676245210728
2018,145,3332,83,3141,69,N,0,14,2,11,-9,-1,-14,9,-1.0407407407407412,0.8333333333333286,0.9638888888888886,4.616666666666664,1.056481481481482,1.4537037037037024,2.147222222222222,2.534259259259258,-0.9231481481481474,1.5092592592592595,-1.7750000000000004,0.41574074074074074,-0.029629629629631893
2018,145,3376,79,3138,63,N,0,16,2,11,-9,-1,-16,9,1.7737891737891722,10.60099715099716,1.9108262108262108,7.612678062678066,-0.6918803418803421,-0.8680911680911692,3.31994301994302,0.8292022792022813,4.116951566951567,2.43888888888889,5.707264957264957,-0.977635327635328,5.546011396011394
2018,146,3257,76,3333,43,N,0,33,1,6,-5,1,33,-5,-0.5032996894409933,3.15702639751553,-2.4068322981366457,-2.8492818322981357,0.6790566770186333,1.131017080745341,0.23786878881987583,-0.8303571428571423,-3.7344720496894404,0.2945458074534173,2.0915178571428577,-2.363354037267081,3.4490489130434785
2018,146,3280,89,3417,73,N,0,16,1,3,-2,1,16,-2,-2.32514880952381,-7.066964285714278,-0.7083333333333339,-0.6555059523809526,-0.3050595238095237,-1.8191964285714306,-7.735863095238095,-2.3258928571428577,-2.8690476190476204,-3.197916666666668,-0.5014880952380949,-1.0892857142857144,-3.8489583333333357
2018,147,3163,94,3376,65,N,0,29,1,2,-1,1,29,-1,7.9631410256410255,5.98317307692308,3.6193910256410255,7.2027243589743595,-2.303685897435898,-5.19471153846154,-0.5761217948717956,4.590544871794872,9.849358974358974,-1.875,3.4503205128205128,-0.7419871794871797,-4.734775641025642
2018,147,3323,84,3332,74,N,0,10,1,2,-1,1,10,-1,2.011781609195399,5.173850574712631,-2.604597701149425,-4.792816091954023,-0.4982758620689651,-0.0775862068965516,2.4738505747126442,-0.18620689655172384,0.4462643678160916,0.4353448275862064,0.3227011494252867,-1.156896551724138,-1.7002873563218408
2018,151,3280,73,3257,63,N,1,10,1,1,0,-1,-10,0,0.734375,-0.8125,0.1875,-1.28125,-2.890625,-2.703125,2.3125,5.78125,1.1875,6.078125,-2.609375,0.125,2.0625
2018,151,3323,91,3163,89,N,1,2,1,1,0,-1,-2,0,3.5007183908046002,-0.3092672413793025,3.231681034482758,6.4615660919540225,0.45869252873563227,0.1713362068965516,-2.0801005747126435,5.888290229885058,5.65373563218391,-1.4353448275862064,3.589798850574713,2.7277298850574714,-1.2517959770114935
2018,153,3323,61,3280,58,N,0,3,1,1,0,-1,-3,0,-5.7024066091954,-4.3717672413793025,0.450431034482758,4.9146910919540225,-0.16630747126436773,-0.3755387931034484,-4.8144755747126435,-2.549209770114942,-4.40876436781609,-4.966594827586206,1.746048850574713,0.4152298850574714,0.8263290229885065
2019,137,3113,60,3416,45,N,0,15,5,12,-7,1,15,-7,1.7121794871794904,1.644871794871797,2.037820512820513,6.153846153846153,0.35448717948717956,0.6621794871794862,0.6814102564102562,1.3269230769230766,4.5160256410256405,-4.530769230769231,-2.856410256410255,-0.1217948717948718,-3.6288461538461547
2019,137,3138,82,3353,71,N,0,11,10,7,3,1,11,3,2.1069389547650417,7.272178304787005,2.0562143170838816,4.854523495827845,6.152283706631534,7.0187747035573125,2.1016688625384283,3.487703118137901,0.9825428194993417,-0.3309178743961354,-0.01592007026789588,-1.9799077733860346,0.12527448397013075
2019,137,3155,79,3377,66,N,0,13,9,8,1,1,13,1,-1.0059716599190267,-1.2480094466936507,-3.715249662618083,-12.408974358974358,-2.1818151147098526,0.40286774628880195,1.5246288798920364,1.0363697705802934,-0.937786774628881,6.90944669365722,3.244871794871795,0.5495951417004048,-2.2278677462888012
2019,137,3163,110,3406,61,H,0,49,2,15,-13,1,49,-13,3.5502688172043015,2.985215053763433,4.39758064516129,8.270698924731182,-3.9293010752688176,-6.1379032258064505,-4.004569892473118,3.3408602150537625,5.645698924731182,-7.925000000000001,-3.781182795698925,-2.5948924731182794,-7.015322580645162
2019,137,3199,70,3137,67,N,0,3,5,12,-7,-1,-3,7,-0.4680900621117985,-5.555900621118013,1.5932453416149075,1.9737577639751542,-0.6304347826086953,-0.5597049689441,-3.827950310559004,1.8659937888198783,2.0663043478260867,1.984782608695653,0.8333850931677009,0.9882763975155284,1.7520186335403736
2019,137,3231,69,3400,65,N,0,4,10,7,3,1,4,3,-1.5182367149758456,-2.2028985507246404,0.2938405797101451,0.2774154589371989,1.5333333333333332,1.1214975845410606,-3.907125603864733,-0.18297101449275388,-1.3269323671497588,-0.9547101449275353,0.4187198067632849,0.5114734299516908,-0.19951690821256207
2019,137,3234,66,3273,61,H,0,5,2,15,-13,1,5,-13,3.6799267399267386,-2.7073992673992677,0.5143956043956042,2.1725641025641025,4.299340659340658,4.18901098901099,-2.1479853479853475,2.3021245421245418,6.312527472527471,1.5728205128205115,-0.9727838827838831,-0.3342857142857145,-1.1043223443223447
2019,137,3257,69,3352,34,H,0,35,1,16,-15,1,35,-15,7.372413793103448,6.072824302134634,-0.11683087027914674,0.8875205254515599,2.222824302134647,0.6536124794745461,-0.8944170771756976,-1.1356321839080437,3.8284893267651903,-5.080131362889981,-3.255172413793103,0.7111658456486043,-1.2871921182265993
2019,137,3266,58,3349,54,N,1,4,5,12,-7,1,4,-7,8.086080586080588,15.875457875457876,1.5013736263736268,3.85393772893773,-0.20833333333333393,0.5815018315018321,4.370879120879122,-0.009157509157510901,4.613553113553113,-4.083791208791212,2.700091575091575,-0.4597069597069594,0.5000000000000018
2019,137,3274,69,3195,62,H,0,7,4,13,-9,-1,-7,9,-2.634615384615387,-0.0737179487179418,2.8125,13.741987179487182,-2.76923076923077,-4.676282051282049,-4.705128205128206,-5.245192307692307,-1.290064102564104,-2.6089743589743613,3.0657051282051277,-0.8782051282051286,-0.6233974358974343
2019,137,3276,84,3243,54,N,0,30,8,9,-1,-1,-30,1,-4.629870129870131,-4.348484848484858,0.5086580086580081,4.599567099567098,0.35497835497835695,-0.12121212121212466,-3.1255411255411243,-1.3398268398268414,-3.1385281385281374,-0.8398268398268378,0.48051948051947946,0.7359307359307357,-2.8203463203463244
2019,137,3280,103,3380,46,H,0,57,1,16,-15,1,57,-15,8.385650623885915,6.071746880570409,1.0224598930481283,-2.511675579322638,4.127183600713012,2.34197860962567,4.234670231729057,-1.6091800356506205,3.6620320855614974,-4.975222816399288,-1.2658645276292333,2.3962566844919784,-4.808556149732624
2019,137,3281,77,3179,76,N,1,1,7,10,-3,-1,-1,3,5.928483835005579,9.815774804905239,0.8059085841694529,2.7588628762541774,3.225418060200669,3.483444816053513,1.883779264214045,2.317224080267561,7.329654403567448,2.155406911928651,2.604347826086956,-0.5995540691192867,1.0747491638795985
2019,137,3332,78,3340,40,H,0,38,2,15,-13,1,38,-13,4.589285714285715,5.026785714285708,3.0863095238095237,8.089285714285715,-3.5357142857142865,-3.9732142857142865,0.7559523809523796,-2.139880952380949,1.8273809523809526,-4.3125,-2.6607142857142856,-2.8333333333333335,-0.19940476190476097
2019,137,3376,74,3125,52,N,0,22,4,13,-9,-1,-22,9,-0.6517094017094038,-3.349816849816847,3.9163614163614167,10.162087912087912,-4.4212454212454215,-5.184676434676435,-2.6361416361416357,3.6401098901098905,3.370573870573871,-0.6050061050061046,-2.478021978021978,-4.268009768009768,-1.4020146520146533
2019,137,3401,84,3460,61,H,0,23,4,13,-9,1,23,-9,-1.3408882783882774,-8.861492673992672,-2.576236263736264,-9.639880952380953,2.4713827838827847,3.5064102564102555,-3.7994505494505493,1.292582417582416,0.20833333333333215,2.9116300366300365,-0.6494963369963376,0.7193223443223444,-1.8461538461538503
2019,138,3124,95,3101,38,H,0,57,1,16,-15,-1,-57,15,-2.734484059611397,-9.014808526693074,4.317109979249199,15.464346349745329,-1.6859083191850601,-2.49085078287116,-1.524052065647993,-7.731937370307492,-2.3989813242784397,4.609601961893983,1.050273533295604,-3.3496510092435385,2.3311639313337125
2019,138,3140,73,3120,64,N,0,9,7,10,-3,-1,-9,3,0.6834920634920607,2.355079365079362,-0.14920634920634868,0.0501587301587314,1.4226984126984128,2.5607936507936486,1.3341269841269838,-5.412539682539684,-3.4431746031746044,-0.7376190476190487,4.002857142857143,-2.8361904761904757,1.5641269841269825
2019,138,3143,92,3314,72,N,0,20,8,9,-1,1,20,-1,-0.29772347535505617,-3.130639097744364,-0.8055555555555554,-3.9524853801169613,-1.39327485380117,-0.7597117794486223,0.5091896407685894,1.0661027568922314,-0.026733500417710943,-0.3232038429406856,-3.063387635756058,0.03571428571428559,-1.9193817878028412
2019,138,3211,68,3114,51,N,0,17,5,12,-7,-1,-17,7,-2.9309523809523803,-4.875,-0.9369047619047621,-1.4154761904761912,-4.220238095238097,-4.725000000000001,-2.4904761904761905,-1.4333333333333336,-1.0773809523809543,1.450000000000001,-2.1690476190476184,-1.807142857142857,1.6583333333333314
2019,138,3235,97,3308,61,H,0,36,3,14,-11,1,36,-11,1.9733333333333327,0.8658333333333346,3.801666666666666,8.945,-0.041666666666666075,-2.955833333333338,-2.116666666666667,0.008333333333336412,2.340833333333334,-3.308333333333332,-2.694166666666666,-0.8541666666666661,-1.3841666666666654
2019,138,3246,82,3343,77,N,0,5,6,11,-5,1,5,-5,0.16098484848484418,0.6856962481962512,-0.31935425685425667,-2.388528138528141,1.0785533910533918,1.8206168831168839,1.1145382395382395,-4.68082611832612,-1.8007756132756132,-1.2284451659451676,0.7518939393939394,-1.2095959595959593,3.15413059163059
2019,138,3268,73,3347,51,H,0,22,3,14,-11,1,22,-11,4.704761904761902,-0.09333333333333371,0.23809523809523725,-1.922619047619051,1.0442857142857154,0.0790476190476177,-0.8452380952380967,-2.4250000000000007,3.6726190476190457,1.3873809523809513,1.5135714285714288,0.5945238095238095,4.6514285714285695
2019,138,3277,88,3141,87,N,0,1,9,8,1,-1,-1,-1,1.9767532467532476,0.5724675324675346,1.5494805194805181,4.571818181818184,-2.408116883116884,-4.6009090909090915,0.23292207792207797,1.702987012987009,-0.499415584415587,-1.2240909090909078,-1.2061688311688314,-0.7159740259740257,-4.087272727272726
2019,138,3283,89,3177,78,N,0,11,11,6,5,-1,-11,-5,1.5494372776981464,5.366950682168074,6.121064925412753,19.474717311673835,-1.539443648139299,-4.106333280246325,-0.3263523915697828,-1.8161065987152938,5.757034028773159,0.04492488188140342,-0.8087805913892883,-1.9615915485480704,-0.3326962892180312
2019,138,3301,63,3263,51,H,0,12,3,14,-11,-1,-12,11,-1.7048351648351634,-0.0274725274725256,-0.12351648351648414,4.023296703296705,-2.9740659340659334,-3.621208791208794,0.7531868131868151,-7.901208791208791,1.4494505494505496,-2.5487912087912097,4.381758241758242,-0.7059340659340663,3.1404395604395603
2019,138,3323,92,3126,50,H,0,42,1,16,-15,-1,-42,15,-9.153508771929825,-6.299999999999997,0.8403508771929826,3.1736842105263143,-2.757894736842106,-1.3692982456140363,-0.23684210526315752,-2.3614035087719323,-6.807894736842105,1.8078947368421048,0.6315789473684221,-2.1956140350877194,2.2377192982456116
2019,138,3333,80,3129,75,H,1,5,4,13,-9,-1,-5,9,-1.5299908424908395,3.9368131868131826,-1.2417582417582427,-0.5510531135531131,0.6994047619047628,0.10874542124541975,1.5064102564102555,-5.751373626373628,-1.120421245421248,3.562957875457876,4.397893772893774,-0.11790293040293065,4.25
2019,138,3355,76,3346,65,N,0,11,6,11,-5,-1,-11,5,-6.1987179487179525,0.4038461538461462,-1.5641025641025639,1.474358974358971,-2.634615384615385,-1.3012820512820529,3.352564102564102,-4.737179487179489,-3.7884615384615365,-0.5769230769230766,3.1602564102564115,0.3205128205128207,-0.8461538461538467
2019,138,3390,79,3413,54,H,0,25,2,15,-13,1,25,-13,3.0029761904761934,3.488095238095241,0.27380952380952284,0.2857142857142847,-0.5178571428571423,0.22023809523809668,2.4017857142857153,-2.9434523809523796,-0.21130952380952372,-1.8035714285714288,-0.7142857142857144,1.7380952380952377,-1.6488095238095255
2019,138,3393,70,3200,49,H,0,21,3,14,-11,-1,-21,11,-6.226666666666667,-10.765,-1.4241666666666681,-3.810833333333335,-2.3808333333333325,-3.2616666666666667,-3.3599999999999994,-1.9741666666666617,-3.6166666666666636,-3.6466666666666665,-3.575,-3.163333333333334,-3.8825000000000003
2019,138,3417,89,3397,77,N,0,12,6,11,-5,-1,-12,5,0.8776315789473692,-0.12456140350877831,0.26140350877192997,-0.2956140350877199,-0.3925438596491233,-0.19824561403508767,-0.9561403508771917,2.257894736842104,0.07543859649122808,2.527631578947368,0.4802631578947363,-1.4030701754385961,1.6425438596491198
2019,139,3113,57,3274,55,A,0,2,5,4,1,1,2,1,-1.8999999999999986,-0.7333333333333272,-1.0374999999999996,-0.9791666666666643,-2.6999999999999993,-3.7416666666666636,-0.11666666666666714,-3.4375,1.104166666666666,-3.8416666666666686,0.37916666666666643,-1.291666666666667,-3.2041666666666657
2019,139,3163,84,3138,72,H,0,12,2,10,-8,-1,-12,8,-2.400148044257442,-1.9870266479663314,-1.7537400654511455,-1.0674380551659652,6.71517064048621,7.255415303101138,2.4872993610721537,-4.142551036309804,-2.7727520648278006,5.47463768115942,4.775868786037089,-1.3165809568334113,7.034283933302163
2019,139,3234,68,3281,52,H,0,16,2,7,-5,1,16,-5,7.716945373467116,9.187569676700114,-2.8928093645484942,-6.003957636566334,0.6677257525083604,0.002675585284283244,-0.37904124860646604,1.6890189520624297,7.400167224080265,-2.6458751393533984,0.5787068004459304,0.4260869565217389,-2.739353400222967
2019,139,3257,71,3276,50,H,0,21,1,8,-7,1,21,-7,2.4105090311986856,3.857889237199572,2.3695327660844896,8.900507538438573,-0.8282579489476021,-2.705478429616363,-1.232945215703836,-3.3460217942976556,1.2594417077175706,-4.351992834751455,-0.633527392148082,0.27436930885206756,1.1526347216002364
2019,139,3280,85,3155,61,H,0,24,1,9,-8,-1,-24,8,-3.2995614035087684,0.927631578947377,-1.9114035087719294,-3.283333333333335,-2.707456140350878,-1.4048245614035082,-2.189473684210528,4.868421052631575,-2.4570175438596493,6.468421052631577,4.149999999999999,-0.36578947368421044,0.0298245614035082
2019,139,3332,91,3231,68,H,0,23,2,10,-8,-1,-23,8,-5.432142857142857,-6.535714285714278,-3.536904761904762,-8.945238095238096,3.836904761904762,5.438095238095238,-1.0511904761904756,2.3214285714285694,-5.828571428571431,5.3273809523809526,-0.052380952380952195,0.7261904761904758,3.326190476190476
2019,139,3376,72,3199,64,H,0,8,4,5,-1,-1,-8,1,-2.976751207729471,-2.456004140786746,-0.43292788129744686,0.9381469979296071,-2.3933747412008284,-3.6351363008971695,-0.3014147688060742,-0.6493271221532098,-0.8893202208419595,0.8608523119392686,-0.28933747412008337,-2.452165286404417,0.8348861283643885
2019,139,3401,78,3266,76,H,0,2,4,5,-1,-1,-2,1,4.85096153846154,7.11057692307692,4.236492673992673,11.285485347985347,-2.5684523809523814,-3.5494505494505475,0.6804029304029307,-0.8484432234432262,4.714743589743591,-2.845695970695971,2.9709249084249088,-1.0728021978021975,-0.15476190476190155
2019,140,3124,102,3143,63,H,0,39,1,8,-7,1,39,-7,0.8404782116581799,2.9570599886813795,-4.201612903225806,-13.159521788341822,2.8350311262026047,3.2021080928126757,0.7126485568760614,5.899335031126203,2.6489813242784397,0.7639360498019236,1.3261884550084897,3.080645161290322,1.4787775891341255
2019,140,3283,69,3235,60,A,0,9,11,3,8,-1,-9,-8,-0.09490338164251,-0.7489009661835766,3.673647342995169,11.641557971014493,-1.382850241545892,-4.480893719806765,-4.036654589371979,2.121256038647342,1.0062922705314001,-1.3895531400966181,-2.3520772946859907,0.24788647342995151,-2.462971014492755
2019,140,3301,72,3246,57,H,0,15,3,6,-3,-1,-15,3,0.4214743589743577,6.090979853479858,-0.6936355311355316,-0.6181318681318686,0.6248626373626394,0.22248168498168397,2.2572344322344335,-8.187042124542124,-0.4261446886446887,-1.3474816849816857,5.997115384615385,0.4435897435897438,6.596749084249083
2019,140,3323,91,3277,63,H,0,28,1,9,-8,-1,-28,8,-4.034848484848485,-1.3681818181818173,2.8257575757575766,6.218181818181815,-2.370454545454546,-2.625757575757575,0.16136363636363704,-3.293939393939393,-0.6977272727272705,0.3340909090909072,1.4704545454545466,-1.712121212121212,3.2439393939393923
2019,140,3333,76,3211,70,H,0,6,4,5,-1,-1,-6,1,-1.3720238095238102,0.6785714285714306,-3.928571428571429,-11.00297619047619,4.877976190476192,5.4851190476190474,2.9761904761904745,-5.964285714285715,-0.3154761904761916,0.6934523809523814,5.261904761904762,0.39583333333333304,2.2857142857142847
2019,140,3355,75,3393,64,A,0,11,6,3,3,1,11,3,0.22756410256410575,-6.391025641025635,-1.1041666666666679,-6.044871794871796,3.051282051282053,3.2980769230769234,-3.365384615384615,1.123397435897438,0.42788461538461675,-1.9983974358974361,-1.1538461538461542,-1.1794871794871802,0.28685897435897445
2019,140,3390,72,3140,63,H,0,9,2,7,-5,-1,-9,5,-1.4354761904761908,-2.1447619047619,-2.01547619047619,-6.314047619047617,0.38285714285714256,-0.4219047619047611,-0.43928571428571495,0.6109523809523836,0.36380952380952536,1.36857142857143,0.6042857142857141,-0.33642857142857174,2.6521428571428594
2019,140,3417,85,3268,80,A,0,5,6,3,3,-1,-5,-3,0.18809523809523654,-5.216666666666669,0.4797619047619044,-0.264285714285716,-0.4107142857142847,-0.07261904761904958,-4.303571428571429,1.2250000000000014,2.28095238095238,1.5940476190476183,-0.4047619047619051,0.21785714285714253,1.1130952380952337
2019,144,3163,69,3417,61,H,0,8,2,6,-4,1,8,-4,0.6086021505376351,0.22688172043010013,3.7309139784946233,7.704032258064515,-3.245967741935484,-3.9712365591397862,-4.737903225806452,4.8741935483870975,2.8206989247311824,-3.5666666666666664,-2.022849462365592,-0.7032258064516128,-4.248655913978496
2019,144,3257,61,3333,44,N,0,17,1,4,-3,1,17,-3,2.062294745484401,5.690681444991782,-1.0108784893267657,0.854782430213465,1.0686576354679822,0.2184934318554994,2.2270114942528725,-7.592775041050903,1.9261083743842349,-0.09144088669950712,2.9638752052545163,0.6117610837438425,4.949712643678161
2019,144,3280,76,3113,53,N,0,23,1,5,-4,-1,-23,4,-4.541666666666664,-1.8166666666666629,0.1750000000000007,4.633333333333333,-5.508333333333333,-5.925000000000001,-3.0583333333333336,3.6666666666666643,0.47499999999999964,-1.783333333333335,-0.7833333333333332,-1.5499999999999998,-2.875
2019,144,3332,63,3355,53,H,0,10,2,6,-4,1,10,-4,1.8379120879120876,3.676739926739913,1.1785714285714288,2.2651098901098905,-3.438186813186814,-4.411172161172162,0.5082417582417573,-2.2989926739926716,0.5215201465201496,-3.5164835164835146,-0.4354395604395602,-0.9217032967032965,-3.867216117216117
2019,145,3124,93,3376,68,N,0,25,1,4,-3,1,25,-3,0.13799283154121866,-0.5545314900153642,-2.919866871479775,-11.330261136712751,0.056835637480800116,-0.25601638504864255,-0.782130056323604,8.417818740399387,5.578597030209934,0.936763952892985,-2.1459293394777266,0.6203277009728616,-0.28187403993855753
2019,145,3234,79,3301,61,A,0,18,2,3,-1,1,18,-1,4.717948717948719,2.0051282051282087,-2.157692307692308,-3.801282051282051,-0.04615384615384599,-0.8807692307692321,-1.6205128205128183,-2.570512820512821,7.507692307692306,-1.0102564102564102,2.4089743589743593,0.2769230769230768,2.058974358974357
2019,145,3323,87,3401,80,H,0,7,1,4,-3,1,7,-3,6.643452380952382,5.508928571428569,0.6505952380952378,2.1898809523809533,0.6529761904761902,0.11666666666666714,-0.4761904761904763,1.1369047619047628,5.991666666666667,-1.515476190476189,0.664880952380952,1.3345238095238092,-0.6499999999999986
2019,145,3390,55,3283,46,N,0,9,2,11,-9,-1,-9,9,-0.12223947550034708,1.709972394755006,-3.520790200138026,-10.044772256728777,3.5257073844030344,4.867322291235334,2.9348688750862646,0.393029675638374,-2.391649413388542,2.4056245686680473,1.9763630089717052,-1.7568150448585227,3.7901138716356115
2019,146,3163,80,3257,73,H,0,7,2,1,1,1,7,1,-1.5138116425658126,1.4492955135335563,1.601316277345198,0.8962736373748612,-1.6152206154987034,-0.5784204671857616,0.2434186132740077,7.259825732295141,-0.023266592510196915,-1.8936781609195403,-1.1593437152391548,-0.19058212829069365,-5.3650352243233215
2019,146,3332,88,3280,84,H,0,4,2,1,1,-1,-4,-1,-0.5904761904761919,-3.1190476190476133,-3.078571428571429,-9.936904761904763,5.486904761904762,7.671428571428573,5.090476190476192,-3.470238095238095,-2.4035714285714302,3.769047619047619,0.772619047619048,2.0678571428571426,3.292857142857141
2019,147,3124,85,3234,53,N,0,32,1,2,-1,1,32,-1,-2.3320926385442498,3.974772539288665,-2.163151364764268,-9.159015715467328,2.849875930521094,4.524813895781637,4.430934656741108,5.066170388751036,-2.6637717121588054,0.5033085194375513,-0.41790736145574847,3.080645161290322,1.729114971050457
2019,147,3323,84,3390,68,H,0,16,1,2,-1,1,16,-1,3.8845238095238095,1.9285714285714306,-4.048809523809524,-11.610714285714284,5.042857142857143,5.688095238095238,0.9107142857142847,3.630952380952383,2.557142857142857,1.7285714285714295,-0.3857142857142861,0.12023809523809526,0.9154761904761912
2019,151,3124,72,3332,67,N,0,5,1,2,-1,1,5,-1,-2.413594470046082,-0.9711981566820214,-5.630184331797235,-16.360023041474655,4.884216589861753,7.192396313364055,1.8329493087557616,7.769009216589861,0.6480414746543772,4.051843317972349,-0.6042626728110596,4.348502304147464,2.1347926267281103
2019,151,3323,81,3163,76,N,0,5,1,2,-1,-1,-5,1,-2.874731182795699,2.1935483870967687,4.6392473118279565,10.829032258064515,-5.770967741935484,-6.979569892473119,-0.11290322580645196,0.6075268817204282,-0.8209677419354833,-4.300000000000001,-1.4645161290322575,-1.7198924731182794,-2.4736559139784937
2019,153,3124,82,3323,81,N,0,1,1,1,0,1,1,0,-3.1731182795698913,-0.18548387096774377,-0.8849462365591396,-5.356451612903227,-1.0693548387096765,-1.4956989247311832,0.7258064516129039,3.405913978494624,0.7516129032258085,-0.03387096774193665,-0.8435483870967735,1.2639784946236556,1.0586021505376344
2021,139,3124,101,3238,52,N,0,49,2,15,-13,1,49,-13,8.493333333333332,13.564444444444447,-0.7333333333333334,-0.905555555555555,-4.67888888888889,-6.41,2.3311111111111096,3.6944444444444464,10.17111111111111,-3.785555555555556,0.5733333333333333,0.7544444444444447,-4.727777777777778
2021,139,3163,102,3219,59,N,0,43,1,16,-15,1,43,-15,9.845833333333328,3.5208333333333286,-0.45000000000000107,-8.166666666666664,-2.741666666666667,-1.5083333333333364,1.8916666666666666,0.46666666666666856,5.866666666666664,0.4833333333333343,2.695833333333333,2.6166666666666663,2.958333333333332
2021,139,3210,54,3372,52,N,1,2,5,12,-7,1,2,-7,-0.8094696969696962,1.3598484848484844,0.1071969696969699,-1.2727272727272734,-1.5549242424242422,-3.6628787878787854,-0.8526515151515159,-0.4075757575757599,-0.954545454545455,-4.6344696969696955,-7.351136363636363,-1.3916666666666666,-4.904166666666667
2021,139,3234,87,3141,72,N,0,15,5,12,-7,-1,-15,7,-3.756944444444443,0.48611111111111427,0.46527777777777857,4.965277777777775,-2.083333333333332,-2.458333333333332,1.2013888888888893,-2.1180555555555536,-6.923611111111111,-1.0694444444444464,1.1180555555555554,0.11111111111111116,1.0347222222222232
2021,139,3246,71,3226,63,N,0,8,4,13,-9,-1,-8,9,-0.8448879551820738,-0.7338935574229666,-1.145483193277311,-0.9273459383753497,-0.4404761904761898,0.44397759103641476,0.4003851540616239,5.567051820728292,1.2107843137254903,2.3125,-1.6426820728291318,-0.9448529411764706,-1.502626050420167
2021,139,3276,87,3195,66,N,0,21,6,11,-5,-1,-21,5,0.710714285714289,3.9994047619047706,6.048214285714286,20.420833333333327,-5.206547619047619,-6.020238095238096,-6.1535714285714285,3.5749999999999993,-0.5815476190476208,-1.6226190476190467,3.25297619047619,0.7005952380952385,-1.2976190476190474
2021,139,3301,79,3299,58,N,0,21,1,16,-15,-1,-21,15,-4.14423076923077,0.44038461538461604,-1.4576923076923078,0.7403846153846132,-2.2019230769230766,-3.3365384615384617,6.094230769230769,-7.228846153846153,-1.9192307692307704,4.15,5.903846153846153,2.144230769230769,1.7442307692307697
2021,139,3329,84,3448,61,N,0,23,8,9,-1,1,23,-1,2.6597222222222214,6.263888888888886,-0.6041666666666661,-1.8472222222222214,-3.3472222222222214,-2.9444444444444446,0.9236111111111107,3.319444444444443,5.736111111111111,-0.0625,2.6250000000000018,3.9583333333333326,-0.09722222222222143
2021,139,3333,83,3199,59,N,0,24,8,9,-1,-1,-24,1,-0.4767857142857146,4.17321428571428,-2.7321428571428577,-3.6482142857142854,-1.0321428571428566,-1.2482142857142833,3.0303571428571425,-5.523214285714285,-4.007142857142858,0.7232142857142883,3.305357142857143,-1.6321428571428567,3.5428571428571445
2021,139,3376,79,3273,53,N,0,26,1,16,-15,-1,-26,15,-1.1578282828282838,-2.23484848484847,1.5340909090909092,1.6325757575757578,-1.5808080808080796,-3.6780303030303028,-2.849747474747474,-7.5,1.724747474747474,-3.34090909090909,1.242424242424243,-2.6729797979797976,0.6212121212121193
2021,139,3378,57,3450,53,N,0,4,8,9,-1,1,4,-1,-3.128787878787879,-2.794191919191917,0.19318181818181834,1.7020202020202042,2.6401515151515156,4.186868686868689,1.794191919191917,1.2222222222222214,0.07954545454545325,0.6565656565656557,-1.7613636363636358,-1.291666666666666,-3.5467171717171695
2021,139,3390,87,3430,44,N,0,43,1,16,-15,1,43,-15,7.118333333333332,9.54333333333333,0.5216666666666665,1.0050000000000026,-1.7833333333333314,-2.2750000000000004,1.843333333333332,1.4466666666666654,-2.3450000000000006,-4.398333333333333,1.6533333333333342,2.865,0.788333333333334
2021,139,3393,72,3355,55,N,0,17,8,9,-1,-1,-17,1,-4.26625457875458,-6.057005494505489,-0.6820054945054945,-1.7142857142857153,-0.7941849816849818,-1.635531135531135,-1.9114010989011003,-1.1506410256410255,-2.4977106227106223,-0.585164835164834,2.4109432234432226,-3.161858974358974,0.13255494505494525
2021,139,3397,87,3292,62,N,0,25,3,14,-11,-1,-25,11,-2.40126050420168,0.5336134453781511,4.459033613445379,15.340073529411768,3.08876050420168,5.644170168067227,-1.5785189075630246,-1.9881827731092407,-2.3647584033613445,-5.155724789915967,1.226890756302521,-2.5047268907563027,1.7844012605042021
2021,139,3439,70,3266,63,N,0,7,7,10,-3,-1,-7,3,1.2050960735171259,1.2044695071010807,-5.701127819548873,-13.831871345029242,-1.8625730994152043,-1.5549289891395137,3.428362573099415,-1.05409356725146,2.8548454469507103,2.306599832915623,3.1879699248120303,-1.3897243107769421,-3.7291144527986635
2021,139,3452,77,3250,53,N,0,24,4,13,-9,-1,-24,9,-0.6023809523809547,2.9857142857142804,3.947619047619048,11.241269841269844,-1.355555555555556,-2.4611111111111086,-2.0198412698412707,4.43015873015873,1.3412698412698418,-3.8095238095238066,-2.434920634920635,-2.231746031746032,-2.0579365079365086
2021,140,3104,80,3314,71,N,0,9,7,10,-3,1,9,-3,-1.4229166666666657,-6.262232905982913,1.3570512820512821,1.1168269230769212,0.8524038461538463,0.608600427350428,-2.5592414529914524,-2.326442307692311,-0.7548611111111114,0.09674145299145209,-1.635256410256411,-0.8339743589743591,-1.4967948717948705
2021,140,3112,79,3392,44,N,0,35,3,14,-11,1,35,-11,1.3916666666666693,4.672916666666666,1.635416666666666,2.6374999999999993,1.59375,0.9791666666666679,-2.6875,0.904166666666665,-2.002083333333333,-2.872916666666667,2.095833333333334,1.166666666666667,2.697916666666668
2021,140,3125,64,3211,59,N,0,5,12,5,7,1,5,7,-2.4956521739130437,1.4358695652173878,2.6014492753623184,8.60072463768116,-0.011956521739131531,0.1757246376811601,0.733695652173914,-2.6909420289855106,-2.3442028985507264,-0.2025362318840589,3.315579710144929,0.22644927536231885,6.252898550724639
2021,140,3140,69,3353,66,N,0,3,11,6,5,1,3,5,-3.3956349206349223,-3.9531746031746096,-0.7861111111111114,0.6690476190476176,-2.230952380952383,-2.5658730158730148,-2.5996031746031747,3.6841269841269835,-0.00833333333333286,1.3436507936507933,-4.527777777777778,-1.007936507936508,-2.5996031746031747
2021,140,3208,67,3180,53,N,0,14,3,14,-11,-1,-14,11,-2.347619047619048,-2.5845238095238017,1.8113095238095243,5.449404761904763,-3.366666666666667,-4.672023809523811,-1.7958333333333343,-4.442261904761903,-0.40000000000000036,-6.308928571428572,0.48452380952380913,-3.36547619047619,-1.409523809523808
2021,140,3231,63,3433,32,N,0,31,4,13,-9,1,31,-9,5.433333333333334,4.888888888888886,-2.0444444444444443,-2.5666666666666664,0.23888888888888715,1.4166666666666679,-1.4722222222222214,3.272222222222222,1.488888888888889,-1.5444444444444443,-1.3499999999999996,1.2277777777777779,2.5500000000000007
2021,140,3235,79,3277,75,N,0,4,7,10,-3,1,4,-3,-1.4645833333333371,-1.0458333333333343,3.289583333333333,8.34375,1.4562500000000007,-1.7541666666666664,-2.2687500000000007,3.097916666666663,-2.5000000000000018,-0.9895833333333339,-3.2333333333333325,-0.4979166666666668,-5.835416666666665
2021,140,3257,74,3265,43,N,0,31,2,15,-13,1,31,-13,5.061594202898554,6.227053140096615,0.6690821256038646,2.971014492753625,-0.8345410628019323,-2.421497584541065,-0.8067632850241537,-0.8297101449275353,-2.90096618357488,-2.824879227053138,-0.38647342995169076,1.9504830917874392,1.2463768115942013
2021,140,3268,98,3291,45,N,0,53,2,15,-13,1,53,-13,5.677083333333332,3.947916666666657,0.6041666666666679,-3.0104166666666714,3.0625,4.052083333333332,1.15625,-0.1458333333333286,4.958333333333332,0.78125,-0.29166666666666785,-0.7083333333333339,-2.2604166666666643
2021,140,3283,70,3413,51,N,0,19,5,12,-7,1,19,-7,2.8057692307692292,10.138461538461534,-3.934615384615385,-6.4346153846153875,-0.9326923076923066,0.21923076923076934,6.769230769230769,-2.303846153846152,-2.5711538461538463,1.9076923076923062,3.5596153846153857,-1.580769230769231,-0.6365384615384624
2021,140,3321,62,3416,51,N,0,11,7,10,-3,1,11,-3,2.8854166666666643,11.779166666666669,0.8583333333333334,6.743749999999999,1.2958333333333343,1.6916666666666664,0.9666666666666668,-1.2958333333333343,3.0458333333333325,-6.335416666666667,2.5124999999999993,1.0645833333333332,0.12083333333333357
2021,140,3332,67,3377,47,N,0,20,6,11,-5,1,20,-5,1.6325854700854734,3.032692307692308,1.4663461538461542,0.9949786324786309,-4.293910256410257,-6.093696581196582,0.4898504273504276,-0.7405982905982924,1.828098290598291,0.508226495726495,0.3706196581196579,0.5212606837606839,-3.9134615384615383
2021,140,3400,81,3133,62,N,0,19,6,11,-5,-1,-19,5,0.039457070707069164,-2.787878787878782,2.3071338383838373,5.867108585858585,-0.8125,-2.5782828282828305,-3.233901515151514,6.029671717171716,1.3046085858585847,-1.3115530303030312,-1.730744949494948,1.558080808080808,-2.038194444444443
2021,140,3401,84,3407,80,N,0,4,2,15,-13,1,4,-13,-3.6000000000000014,-17.026086956521723,-1.215217391304348,-5.785869565217389,-2.3163043478260867,-3.2934782608695627,-9.811956521739132,-4.956521739130437,-2.702173913043479,-0.5326086956521738,-0.8739130434782609,0.4391304347826086,-3.2086956521739154
2021,140,3417,69,3461,48,N,0,21,3,14,-11,1,21,-11,1.0414682539682545,7.169742063492066,-0.9630952380952369,-1.9373015873015902,5.242559523809524,6.907142857142858,5.68829365079365,-1.1869047619047635,0.7655753968253958,0.17192460317460423,3.4945436507936503,0.10019841269841301,-0.05069444444444393
2021,140,3460,66,3116,62,N,0,4,13,4,9,-1,-4,-9,4.633197577276526,3.1232769423559006,5.14202172096909,8.750417710944024,3.6124686716791974,1.7908312447786088,-9.226608187134504,-3.1265664160401023,2.4370822890559722,-3.6122598162071853,0.3715016708437764,-0.914734753550543,-3.165100250626569
2021,141,3124,90,3439,48,N,0,42,2,7,-5,1,42,-5,5.861587301587303,8.885873015873017,-5.764285714285715,-15.105555555555558,0.5377777777777784,2.6868253968253963,5.525555555555554,3.7388888888888907,6.197301587301586,1.7906349206349201,3.6376190476190473,0.5790476190476195,-3.731746031746031
2021,141,3163,83,3393,47,N,0,36,1,8,-7,1,36,-7,7.1891025641025585,-0.4230769230769198,2.6810897435897427,-1.7916666666666643,-3.0560897435897445,-4.272435897435898,-2.947115384615385,2.1410256410256423,4.782051282051279,-1.9423076923076916,0.3365384615384617,-1.0785256410256414,2.501602564102562
2021,141,3210,73,3452,56,N,0,17,5,4,1,1,17,1,-0.5648809523809533,-0.005952380952379599,-0.06488095238095326,1.4523809523809526,-3.229166666666666,-3.0416666666666643,0.3648809523809504,0.9690476190476183,-0.21428571428571352,-3.4970238095238066,-1.7613095238095235,-1.201190476190476,-2.6898809523809533
2021,141,3234,86,3246,72,N,0,14,5,4,1,1,14,1,4.817810457516337,-2.04738562091503,2.505310457516339,2.751225490196081,2.2222222222222214,1.678104575163399,-3.028186274509805,3.4162581699346397,7.183006535947712,2.3402777777777786,-2.535539215686275,-1.361519607843137,-0.3002450980392162
2021,141,3276,70,3397,55,N,0,15,6,3,3,1,15,3,-0.9785714285714313,-3.049999999999997,-0.07500000000000018,1.8455357142857167,4.444642857142858,4.822321428571428,-1.7705357142857139,-0.9991071428571416,0.4491071428571445,-1.661607142857143,-1.071428571428572,-2.873214285714286,1.3348214285714306
2021,141,3301,79,3378,67,N,0,12,1,8,-7,1,12,-7,8.041666666666668,6.897222222222219,-1.4333333333333336,-4.902777777777779,-0.625,-1.1527777777777786,-3.2972222222222207,6.769444444444442,1.4000000000000004,-1.5944444444444432,-0.41666666666666696,0.375,1.302777777777779
2021,141,3376,59,3333,42,N,0,17,1,8,-7,-1,-17,7,-2.1379870129870113,-12.053896103896093,4.141233766233767,6.151623376623377,1.02077922077922,-0.725649350649352,-7.731493506493506,-0.8642857142857139,3.7707792207792217,-0.3266233766233775,-2.6337662337662335,-1.3769480519480526,0.5116883116883102
2021,141,3390,73,3329,62,N,0,11,1,8,-7,-1,-11,7,-2.541944444444443,1.3455555555555563,-1.0425000000000004,-3.768888888888892,0.061111111111110006,0.4555555555555557,-1.461388888888889,-1.3772222222222226,1.9561111111111114,0.29416666666666913,0.22166666666666757,0.05166666666666586,-3.4272222222222215
2021,142,3112,52,3140,46,N,0,6,3,11,-8,1,6,-8,-1.6972222222222193,1.845138888888897,-0.7701388888888889,-2.2958333333333343,3.310416666666667,5.006944444444443,0.10138888888888964,0.8319444444444457,-4.2354166666666675,-1.4284722222222221,2.3902777777777784,0.4222222222222225,0.5201388888888907
2021,142,3231,70,3125,48,N,0,22,4,12,-8,-1,-22,8,-3.4833333333333343,-4.5305555555555515,4.7444444444444445,10.466666666666669,-3.780555555555555,-5.425000000000001,1.6972222222222229,-5.713888888888892,1.7277777777777779,1.9527777777777775,4.125000000000002,-1.9194444444444443,0.8166666666666664
2021,142,3257,62,3321,53,N,0,9,2,7,-5,1,9,-5,2.6865942028985543,-1.288224637681168,2.2829710144927535,3.7585144927536263,-3.699818840579711,-6.995108695652174,-0.32898550724637765,4.695289855072467,-2.794021739130434,1.0487318840579718,-4.496195652173912,0.6949275362318836,-0.6452898550724644
2021,142,3268,100,3104,64,N,0,36,2,7,-5,-1,-36,5,-5.802083333333332,-7.2048611111111,-0.6875000000000018,0.9895833333333357,-0.5520833333333321,0.3576388888888893,-2.1909722222222214,0.8229166666666643,-3.6423611111111107,-2.3923611111111107,-3.208333333333334,-0.5,2.0
2021,142,3283,64,3460,39,N,0,25,5,13,-8,1,25,-8,2.007539682539683,4.147619047619045,-0.06587301587301564,0.7793650793650784,-3.0059523809523814,-6.542063492063495,-3.055555555555557,0.552380952380954,3.4456349206349213,0.5206349206349206,1.6353174603174612,-0.524603174603175,-2.544047619047621
2021,142,3332,57,3208,50,N,0,7,6,3,3,-1,-7,-3,-2.1214743589743605,-1.3660256410256437,-2.983012820512821,-6.222756410256409,2.7272435897435905,3.096474358974362,1.257371794871796,0.27948717948718027,-1.7586538461538463,5.352884615384616,0.20160256410256405,1.9842948717948712,4.055128205128204
2021,142,3400,71,3417,62,N,0,9,6,3,3,1,9,3,0.5736111111111093,-1.2729166666666742,-1.136111111111111,-4.12222222222222,-0.71875,-0.24444444444444358,0.2958333333333325,-2.269444444444442,-1.8409722222222218,2.847916666666668,-0.8715277777777786,0.8680555555555554,3.300694444444442
2021,142,3401,84,3235,82,N,1,2,2,7,-5,-1,-2,5,-0.13125000000000142,2.201086956521735,5.283967391304348,15.579619565217392,-0.20244565217391397,-2.881521739130438,1.19320652173913,1.8252717391304358,1.4396739130434781,-2.223641304347826,-3.738586956521738,-0.3328804347826084,-2.0850543478260857
2021,145,3112,74,3401,59,N,0,15,3,2,1,1,15,1,-3.0749999999999993,1.1823369565217376,1.1339673913043473,6.098369565217389,-2.0649456521739147,-2.944021739130438,1.9994565217391305,0.29402173913043583,-2.216576086956522,-2.873641304347826,1.2864130434782624,0.46086956521739175,0.6899456521739147
2021,145,3124,78,3276,75,N,1,3,2,6,-4,1,3,-4,5.645714285714288,9.098571428571432,-0.5642857142857141,-5.150000000000002,-3.925714285714287,-3.4385714285714286,2.1914285714285704,3.3000000000000007,7.174285714285713,0.45571428571428463,2.9471428571428575,1.9314285714285715,-3.6642857142857146
2021,145,3163,92,3234,72,N,0,20,1,5,-4,1,20,-4,1.1736111111111072,-0.24305555555555713,0.06944444444444464,-2.208333333333332,-3.1388888888888893,-2.0138888888888893,1.083333333333334,1.847222222222225,-1.097222222222225,-0.5277777777777786,0.770833333333333,2.8333333333333326,2.166666666666666
2021,145,3231,73,3301,70,N,0,3,4,1,3,1,3,3,0.05833333333333357,0.5305555555555515,-2.144444444444445,-3.791666666666668,0.9805555555555543,1.9250000000000007,0.7527777777777764,-3.18611111111111,-2.627777777777778,-2.0777777777777775,0.5999999999999996,1.4194444444444443,0.4583333333333339
2021,146,3257,60,3332,42,N,0,18,2,6,-4,1,18,-4,-0.5265468227424748,-0.8167502787068059,-0.8250418060200673,-0.4184085841694518,0.8315914158305464,0.6388656633221856,0.03671962095875081,0.6831103678929793,-2.6568422519509483,-0.32755016722408037,-0.9404264214046822,0.5792224080267552,2.8265050167224075
2021,146,3376,76,3210,65,N,0,11,1,5,-4,-1,-11,4,-1.7981060606060595,-7.276515151515142,2.0049242424242424,4.96590909090909,-2.282196969696969,-4.219696969696969,-4.909469696969698,-5.066666666666666,2.3636363636363633,-2.361742424242422,-0.8284090909090907,-3.425757575757576,0.5503787878787865
2021,146,3390,89,3283,62,N,0,27,1,5,-4,-1,-27,4,-4.085000000000001,1.8899999999999935,-2.2800000000000002,-3.4300000000000033,-0.4250000000000007,-1.1500000000000004,1.9900000000000002,-1.1799999999999997,-1.504999999999999,1.790000000000001,0.8550000000000004,-3.0900000000000003,-2.505000000000001
2021,146,3400,64,3268,61,N,0,3,6,2,4,-1,-3,-4,6.618055555555557,4.020833333333329,3.3402777777777786,5.326388888888886,2.208333333333332,0.5069444444444429,-1.2708333333333321,3.6527777777777786,5.909722222222221,1.5416666666666643,0.27777777777777857,-0.3472222222222223,-5.402777777777775
2021,147,3112,66,3231,53,N,0,13,3,4,-1,1,13,-1,-5.258333333333333,-4.599305555555546,1.813194444444444,2.7541666666666664,-1.061805555555555,-2.0375000000000014,-0.5152777777777775,-2.3013888888888907,-2.8909722222222225,1.3215277777777779,3.512500000000001,-0.3444444444444441,0.09791666666666643
2021,147,3163,69,3124,67,N,0,2,1,2,-1,-1,-2,1,-1.0858333333333299,8.057500000000005,-5.591666666666666,-9.508333333333336,1.6766666666666676,2.831666666666667,5.219999999999999,2.1416666666666657,2.568333333333335,1.3699999999999992,0.9024999999999999,-0.7066666666666661,-6.033333333333331
2021,148,3376,62,3400,34,N,0,28,1,6,-5,1,28,-5,1.991161616161616,4.484848484848484,-1.4229797979797985,-2.4936868686868685,-0.6136363636363633,-0.04419191919192045,1.6553030303030312,8.694444444444443,-0.14141414141414188,0.4242424242424221,-1.6313131313131306,3.228535353535354,-3.648989898989896
2021,148,3390,78,3257,63,N,0,15,1,2,-1,-1,-15,1,-2.1817391304347815,-1.0940579710145002,0.1613043478260865,0.09101449275362228,-0.07898550724637765,-1.2159420289855074,-0.8723188405797107,-2.6930434782608685,-1.903188405797101,-0.9404347826086941,-1.4286956521739134,-1.7617391304347834,-0.1669565217391309
2021,151,3112,69,3163,59,N,0,10,3,1,2,1,10,2,-9.720833333333328,-1.4562499999999972,-3.7229166666666664,-2.870833333333337,1.9604166666666671,2.054166666666667,0.16249999999999964,-2.120833333333337,-8.910416666666665,-1.40625,2.6750000000000007,-1.216666666666666,-2.7520833333333314
2021,151,3390,66,3376,65,N,0,1,1,1,0,-1,-1,0,-2.5577272727272735,4.108181818181812,-2.5140909090909096,-6.3459090909090925,2.336363636363636,4.161363636363637,3.2286363636363635,1.9699999999999989,-2.6436363636363627,2.030909090909091,-1.7290909090909095,0.29409090909090896,-3.2845454545454533
2021,153,3390,54,3112,53,N,0,1,1,3,-2,-1,-1,2,-6.234999999999999,-3.103749999999998,-0.6612500000000008,-1.542500000000004,2.2437499999999986,2.4124999999999996,-2.0975,-2.4425000000000026,-4.14875,0.2837500000000013,1.5425000000000004,-2.04,-0.7487499999999994
2022,135,3173,88,3177,57,N,0,31,11,11,0,1,31,0,-9.838181818181813,-15.758181818181825,-2.7409090909090903,-8.34,-0.707272727272727,0.8654545454545435,-3.471818181818181,3.324545454545458,-5.002727272727274,-0.4872727272727282,-4.690909090909092,-0.31454545454545446,0.01727272727272755
2022,135,3224,55,3230,51,N,0,4,16,16,0,1,4,0,0.40015284423179054,4.215892477405639,0.22175704412546526,1.614068314726211,2.18984250398724,4.8432183678894205,1.908343301435405,2.57128854332802,0.6731127060074407,1.7788410419989376,0.826488569909622,1.2366261297182346,2.3056053960659213
2022,136,3255,74,3291,70,N,0,4,16,16,0,1,4,0,2.8295454545454533,8.384740259740262,-0.9659090909090908,0.5616883116883145,2.2429653679653683,2.686688311688311,3.5064935064935057,-0.6038961038961048,1.7559523809523814,0.4918831168831197,3.1363636363636376,2.5054112554112553,1.6525974025974008
2022,136,3283,61,3199,50,N,0,11,11,11,0,-1,-11,0,2.792178409825471,-5.73473201989826,0.9277985441668308,-1.231106489418508,-1.6759084904864974,-1.7103510300441247,-4.338720103425986,-0.07338186110564848,2.3060341193333507,2.670146988561312,-2.6842556420561525,-0.47727719850481964,-2.868328602343947
2022,137,3124,89,3218,49,H,0,40,2,15,-13,1,40,-13,5.742592592592594,6.842592592592595,-0.7000000000000011,-1.9083333333333314,0.6157407407407405,0.05462962962963047,1.6759259259259256,2.1685185185185176,3.666666666666666,-0.9787037037037045,-0.7148148148148152,0.7675925925925928,-1.0787037037037024
2022,137,3166,84,3160,74,N,0,10,10,7,3,-1,-10,-3,-5.161363636363635,-4.723484848484858,-4.226767676767677,-8.23169191919192,4.55378787878788,6.960479797979795,0.6012626262626259,-2.787247474747474,-6.943560606060608,1.8969696969696965,3.976136363636363,0.5119949494949498,1.6742424242424292
2022,137,3195,84,3439,81,N,0,3,12,5,7,1,3,7,0.9151802303976204,6.22500929022668,1.6565403195837982,11.870401337792643,-2.431995540691192,-0.6349869936826451,0.4601449275362324,-0.6354515050167215,2.444165737643999,-2.72956150130063,4.576458565589,-0.6276477146042359,1.0021367521367512
2022,137,3208,70,3173,54,H,0,16,6,11,-5,-1,-16,5,-3.253333333333334,-2.9455555555555506,1.933333333333334,6.007222222222223,-0.3022222222222233,1.1838888888888874,-1.7400000000000002,1.153333333333336,-3.527222222222221,-3.065555555555555,-3.3805555555555555,-2.576666666666666,-0.09333333333333549
2022,137,3211,68,3304,55,N,0,13,9,8,1,1,13,1,-5.684294871794876,-9.315705128205124,-2.083333333333332,-6.931089743589741,-0.15865384615384492,-1.157051282051281,0.9743589743589745,-3.540064102564102,-3.615384615384613,0.4551282051282062,-0.42948717948717885,-0.08012820512820484,-1.2596153846153832
2022,137,3234,98,3229,58,H,0,40,2,15,-13,-1,-40,13,-6.955977597281944,-9.175890534586188,-2.1030551574029834,-6.614561766735681,-1.324852683548336,0.17294420555290202,-0.07085788607527732,-3.856585443541963,-7.3323512236555715,-1.608722195678716,-1.9169984604767212,0.11533152837500626,-1.0153421457769305
2022,137,3235,78,3426,71,H,0,7,3,14,-11,1,7,-11,-1.0679487179487204,-3.33287545787546,5.5036630036630045,9.463003663003663,-0.17454212454212303,-4.028479853479855,-2.5597069597069577,0.5830586080586109,-2.1500000000000004,-0.44349816849817003,-2.597619047619048,-0.25769230769230766,-3.431959706959704
2022,137,3242,77,3210,58,N,0,19,8,9,-1,-1,-19,1,-2.491666666666667,-2.396825396825392,-0.17499999999999982,0.39960317460317185,-6.154365079365078,-6.705158730158729,1.6492063492063487,-1.6119047619047606,2.213095238095237,-3.0702380952380945,-2.1353174603174594,-1.73452380952381,-3.7154761904761884
2022,137,3257,83,3107,51,H,0,32,1,16,-15,-1,-32,15,-4.717474747474746,-8.51106060606061,0.4923232323232316,1.8352020202020203,-3.7086868686868684,-3.6366161616161623,-0.8860606060606067,-2.1416666666666657,-1.7002525252525267,1.4417171717171726,-0.8907575757575774,-0.6562626262626257,-1.7916666666666679
2022,137,3268,102,3174,71,H,0,31,4,13,-9,-1,-31,9,-1.5593944099378874,2.37202380952381,-1.5402432712215317,-1.6202122153209118,-1.0632763975155264,0.300077639751553,3.2937370600414084,3.1203416149068346,-2.7400362318840585,0.1950051759834377,-1.9677795031055894,0.26099896480331264,-0.3733178053830244
2022,137,3274,78,3378,66,N,0,12,8,9,-1,1,12,-1,1.3583333333333307,-0.04166666666665719,0.5999999999999996,0.9333333333333371,-0.19166666666666643,0.11666666666666714,-1.7749999999999986,-0.5458333333333343,-0.6833333333333318,2.6875,2.762500000000001,0.0625,1.6374999999999993
2022,137,3376,79,3224,21,H,0,58,1,16,-15,-1,-58,15,-4.678412986489214,-5.348860657390603,-0.8389796329905224,1.4669288162936098,3.0600423472474283,4.551976204880013,-4.29355716878403,-2.1251260334744906,-3.708156886469048,5.311756402500505,4.266535591853195,-3.1517947166767497,5.162482355313571
2022,137,3377,75,3279,61,N,0,14,10,7,3,-1,-14,-3,0.056438127090302714,0.5873745819398053,-3.1139214046822743,-7.294607023411373,2.1234949832775936,3.821864548494986,3.122826086956522,0.7657190635451521,0.07366220735785944,2.565301003344482,1.3345735785953163,0.8080267558528433,1.9812709030100333
2022,137,3390,78,3286,37,H,0,41,1,16,-15,-1,-41,15,-0.9571428571428555,3.9107142857142776,0.1476190476190471,2.042857142857141,3.489285714285714,2.0583333333333336,0.3119047619047617,-3.890476190476189,-1.788095238095238,-2.3738095238095234,2.4571428571428573,-5.926190476190476,1.2809523809523817
2022,137,3400,70,3193,52,H,0,18,2,15,-13,-1,-18,13,-1.693333333333328,-5.879230769230773,0.24820512820512874,2.4156410256410297,-3.7846153846153854,-6.923589743589741,-5.6241025641025635,1.6423076923076927,0.8138461538461534,-3.801794871794872,-3.3071794871794875,-1.3402564102564103,-6.644615384615387
2022,137,3428,92,3116,69,N,0,23,7,10,-3,-1,-23,3,0.40918803418803407,4.049999999999997,-1.1317793317793319,-0.8260101010101017,-1.3459207459207452,0.934343434343436,-1.613189588189588,1.8292735042735053,-2.081157731157731,-3.433818958818959,0.38325563325563294,2.348135198135198,0.20322455322455468
2022,138,3112,72,3424,67,H,0,5,4,13,-9,1,5,-9,-2.7708791208791226,-4.849633699633699,-0.2271062271062272,0.06080586080586059,-0.37573260073260073,-0.3618131868131833,-1.4728021978021992,-6.008424908424907,-0.6072344322344332,-1.100549450549451,2.7214285714285715,1.9225274725274728,3.1013736263736256
2022,138,3125,73,3332,70,N,2,3,12,5,7,1,3,7,-1.2718728639781283,-2.1382433356117616,1.8870471633629524,6.88140806561859,-2.8653451811346553,-3.7486329460013685,-0.138926862611072,-2.674299384825698,0.2769993164730007,0.1442241968557738,-0.22077922077922008,-0.39900888585099104,-1.929084073820917
2022,138,3163,83,3273,38,H,0,45,2,15,-13,1,45,-13,3.7937681159420293,-0.26507246376810656,2.0249275362318837,7.550289855072464,-2.0334782608695665,-3.454782608695652,-1.1042028985507244,-0.4646376811594237,6.088405797101448,0.8573913043478267,0.718550724637681,0.715652173913043,-2.57014492753623
2022,138,3231,85,3150,51,H,0,34,3,14,-11,-1,-34,11,-4.486742424242426,-4.781565656565647,-0.04608585858585812,1.5006313131313114,-0.8207070707070727,-0.8648989898989896,0.662247474747474,-0.7683080808080831,-1.7039141414141419,1.9438131313131315,-1.0732323232323235,0.9368686868686869,-1.1426767676767682
2022,138,3243,50,3450,40,N,0,10,9,8,1,1,10,1,2.0780701754385973,0.19999999999999574,-1.4986842105263163,-3.528947368421054,3.8499999999999996,4.6688596491228065,-1.2657894736842108,2.402192982456139,3.49298245614035,-0.25,0.00833333333333286,1.181578947368421,-0.14385964912280613
2022,138,3261,83,3238,77,H,0,6,3,14,-11,-1,-6,11,-0.7450724637681176,0.030144927536213117,1.0840579710144933,3.6073913043478267,3.830579710144928,6.063188405797099,2.562028985507247,1.4588405797101451,-0.3560869565217395,2.2730434782608686,1.1784057971014494,1.1731884057971014,2.093188405797102
2022,138,3276,74,3110,39,H,0,35,3,14,-11,-1,-35,11,-3.2077569169960505,-4.483119235836632,-0.6785243741765483,-0.03614953886692973,-4.859848484848484,-5.352437417654807,-3.4363471673254287,-2.3890810276679844,-0.19622859025032824,-0.7816205533596836,0.7057806324110665,-0.5176218708827403,-1.560029644268777
2022,138,3301,96,3255,68,H,0,28,1,16,-15,-1,-28,15,-3.1940588147484696,-0.7451858486341223,-0.16972682489923852,2.3338557993730404,3.153679653679653,3.9208837139871626,2.122257053291536,-5.08665472458576,1.555829228243022,4.008508732646664,3.293178086281536,2.7603373637856397,3.811464397671294
2022,138,3314,79,3372,66,N,0,13,5,12,-7,1,13,-7,0.3295707915273134,5.114130434782609,-0.5221571906354514,-2.0327480490523975,-1.8482441471571907,-2.7132107023411365,2.1238851727982144,3.940356744704573,-1.378065774804904,-0.8237179487179471,-1.985367892976587,-0.3658026755852841,-2.4641861761427
2022,138,3323,89,3269,78,N,0,11,5,12,-7,-1,-11,7,-1.7840909090909065,-0.7441724941724956,0.1038752913752905,1.4367715617715646,1.3250291375291354,1.9861596736596745,1.9035547785547777,-1.9978146853146832,-3.261217948717949,-1.6663752913752905,-1.1169871794871797,-1.7654428904428912,1.9759615384615383
2022,138,3326,63,3283,56,N,0,7,6,11,-5,-1,-7,5,-6.363871635610767,-1.6759834368530022,-4.601449275362318,-6.673395445134577,1.7080745341614936,2.120082815734989,4.500517598343688,1.1413043478260896,-4.111283643892339,-0.17236024844720532,-0.16770186335403814,1.608695652173913,1.3592132505175982
2022,138,3328,78,3237,72,H,0,6,4,13,-9,-1,-6,9,-3.8958333333333286,-8.333333333333343,-1.5000000000000009,-3.9375,-4.916666666666666,-5.416666666666664,-0.6666666666666643,-0.4166666666666714,-3.4791666666666643,-3.895833333333332,-3.208333333333334,-0.1875,-6.6875000000000036
2022,138,3343,69,3246,62,N,0,7,11,6,5,-1,-7,-5,1.98941647597254,-1.5557000208030018,-0.4050083211982525,-2.401471811940919,2.214010817557728,4.063319117952986,-3.159975036405241,0.22703869357187045,2.0052267526523817,0.022051175369254494,-1.1666579987518215,3.0871905554399826,-0.9837996671520699
2022,138,3397,80,3138,67,H,0,13,4,13,-9,-1,-13,9,2.2469565217391327,4.134021739130446,1.6786956521739134,5.109347826086957,0.2886956521739137,-1.5197826086956532,-0.30891304347826143,-2.411956521739132,0.7730434782608686,-2.914456521739133,2.551086956521739,-1.339130434782609,-1.8498913043478282
2022,138,3416,69,3196,52,N,0,17,7,10,-3,-1,-17,3,3.006190476190479,5.95809523809524,0.9904761904761905,4.657619047619045,2.532857142857141,3.1857142857142833,-0.5061904761904774,2.5795238095238133,-0.18714285714285595,0.4271428571428544,-3.229047619047618,-0.4247619047619047,5.18095238095238
2022,138,3437,61,3140,57,N,0,4,11,6,5,-1,-4,-5,6.1980211817168325,8.64109531772575,-0.025710702341136482,-0.8290830546265298,0.49512263099219744,0.3483138238573016,2.8575808249721293,0.5647296544035676,4.186454849498327,0.6698021181716829,2.5592948717948723,0.4139492753623193,2.707915273132665
2022,139,3166,64,3234,62,A,0,2,10,2,8,1,2,8,-2.756832298136647,-0.4622153209109712,2.654209799861974,6.121549344375431,-6.17292960662526,-5.69308143547274,2.1496549344375433,-2.5884230503795713,1.969358178053831,-2.2328674948240153,0.002018633540372683,-0.1538992408557629,-0.5879917184265047
2022,139,3235,67,3208,44,H,0,23,3,6,-3,-1,-23,3,2.4512820512820532,4.9491452991453,-5.601282051282052,-13.745940170940171,-2.5175213675213683,-1.4318376068376075,3.852564102564102,-0.5128205128205181,3.0972222222222214,2.13119658119658,3.0138888888888893,2.4743589743589736,1.5974358974358989
2022,139,3257,68,3211,59,H,0,9,1,9,-8,-1,-9,8,-3.008461538461539,-3.6998717948717967,0.7599999999999998,1.7380769230769229,0.8971794871794874,0.4929487179487193,1.5276923076923055,-0.3275641025641036,-0.8737179487179496,-0.6915384615384621,-1.7444871794871801,-0.8184615384615377,0.3237179487179489
2022,139,3268,89,3195,65,H,0,24,4,12,-8,-1,-24,8,-2.6476648351648358,-3.562042124542131,3.521749084249085,16.94894688644689,-4.764423076923077,-3.6023351648351642,-4.363095238095237,2.199175824175825,1.5070970695970711,-2.6087454212454197,0.07486263736263865,-0.07989926739926734,-1.1417124542124562
2022,139,3376,49,3274,33,N,0,16,1,8,-7,-1,-16,7,-3.972126436781611,-8.906609195402297,0.5051724137931028,3.276724137931037,-1.1140804597701148,-2.845977011494254,-7.458908045977012,-4.309482758620689,-2.0267241379310352,3.7298850574712628,4.715804597701149,-3.972701149425288,3.6051724137931025
2022,139,3377,61,3124,47,A,0,14,10,2,8,-1,-14,-8,2.896011396011396,0.5199430199430211,0.43589743589743524,1.079487179487181,4.0411680911680925,5.180056980056982,1.4092592592592599,3.4146723646723665,2.8991452991452977,2.8984330484330485,-0.6840455840455846,0.1977207977207982,0.4732193732193739
2022,139,3390,91,3242,65,H,0,26,1,8,-7,-1,-26,7,0.0595238095238102,0.39682539682539186,-1.2190476190476192,-4.121031746031747,5.003174603174603,4.802777777777777,-2.4408730158730165,1.3761904761904766,-1.6047619047619044,2.692857142857143,1.079365079365079,-2.0595238095238084,0.697619047619046
2022,139,3400,78,3428,56,H,0,22,2,7,-5,1,22,-5,-0.2083333333333357,3.4025641025640994,-3.8069930069930074,-11.212762237762238,-0.7305361305361302,1.4557109557109555,1.9936480186480185,-2.117307692307694,-2.534149184149184,0.7755827505827497,3.63111888111888,0.8481351981351981,4.1027972027972055
2022,140,3163,52,3416,47,H,0,5,2,7,-5,1,5,-5,5.293333333333333,2.5600000000000023,1.2800000000000002,5.139999999999999,-0.8666666666666671,-1.4866666666666681,-1.8399999999999999,1.3133333333333326,4.653333333333332,-2.1400000000000006,-3.9733333333333336,0.9666666666666663,-0.5599999999999987
2022,140,3231,56,3343,55,H,0,1,3,11,-8,1,1,-8,1.4167490118577106,-2.7524703557312336,-0.9483695652173907,-3.362895256916996,4.034584980237156,5.4634387351778635,-5.132164031620553,1.2937252964426875,0.5234683794466406,-2.0308794466403164,-1.466897233201582,0.9807312252964424,-0.733201581027668
2022,140,3276,64,3437,49,H,0,15,3,11,-8,1,15,-8,2.487648221343875,0.4179018445322811,-2.720932147562582,-8.909502635046112,5.512022397891963,7.6595026350461115,2.808629776021081,1.579298418972332,-0.974967061923584,2.941946640316205,0.14204545454545503,-0.5557476943346509,1.9812252964426893
2022,140,3301,89,3243,57,H,0,32,1,9,-8,-1,-32,8,-4.352238354506955,-3.5682093163944373,-1.3435420447670898,-0.5198124621899609,2.5789473684210513,3.058756805807622,-0.3334845735027221,-2.743723532970357,4.48064125831821,0.6046581972171801,0.8745462794918328,3.199788263762855,1.178917120387176
2022,140,3314,63,3112,45,A,0,18,5,4,1,-1,-18,-1,-0.8792960662525893,-8.210559006211184,0.39440993788819867,-0.5955486542443076,-0.4473602484472039,-0.8986024844720468,-3.2216873706004137,-6.551345755693582,0.7483954451345749,-1.2095238095238123,1.1779503105590052,0.14409937888198776,1.6328674948240156
2022,140,3323,108,3328,64,A,0,44,5,4,1,1,44,1,-0.9450757575757578,-3.600378787878796,-3.9564393939393945,-10.339015151515156,-4.8731060606060606,-4.962121212121211,0.2518939393939412,-0.8162878787878824,-1.6041666666666643,-3.3143939393939377,-0.41666666666666785,1.892045454545455,-6.333333333333336
2022,140,3326,79,3261,64,A,0,15,6,3,3,-1,-15,-3,0.41898550724637573,0.8394202898550844,-5.584057971014492,-13.114637681159422,0.8034782608695679,2.313623188405799,2.6662318840579715,3.4143478260869564,-2.520724637681159,0.6943478260869576,-1.6530434782608694,0.41739130434782634,-1.792463768115942
2022,140,3397,70,3125,67,H,0,3,4,12,-8,-1,-3,8,-0.7336603613777513,-4.758575663466971,4.181747600225861,12.442334839073968,-4.102343308865047,-7.4364059853190305,-3.5188805759457935,-6.448157820440429,0.9860954263128168,-3.0366318464144584,1.4518986448334283,-1.8235460191981936,-1.4422289666854908
2022,144,3166,76,3235,68,N,0,8,10,3,7,1,8,7,3.3679487179487175,4.160256410256416,0.8042735042735032,3.4818376068376082,-5.348076923076924,-4.831837606837608,2.058119658119658,-1.6933760683760717,7.483333333333334,-1.1326923076923077,1.658333333333334,-0.6645299145299148,2.230769230769228
2022,144,3376,69,3314,61,N,0,8,1,5,-4,-1,-8,4,-1.1130684657671175,-0.20914542728635865,0.2964767616191901,2.490129935032485,1.1428035982008993,0.02286356821588953,-5.249125437281361,-0.440279860069964,-2.1894052973513247,1.0632183908045985,4.0176161919040485,-3.7679910044977514,2.604447776111943
2022,144,3390,72,3268,66,N,0,6,1,4,-3,-1,-6,3,2.1398809523809526,6.9375,-0.7529761904761907,-2.8958333333333357,3.3601190476190474,2.2946428571428577,1.8333333333333321,-3.8511904761904745,0.02083333333333215,-1.1875,2.2470238095238084,-4.764880952380952,0.1220238095238102
2022,144,3400,66,3326,63,N,0,3,2,6,-4,-1,-3,4,3.3043478260869605,1.7380156075808202,3.095596432552954,7.916945373467115,-2.8447603121516174,-4.913879598662206,-3.3503344481605364,2.1379598662207364,3.8712374581939812,-2.2594760312151614,-1.4908026755852841,-0.21098104793756978,-3.0621516164994453
2022,145,3163,75,3231,58,H,0,17,2,3,-1,1,17,-1,0.9947727272727249,-2.8531818181818096,0.9424999999999999,2.226590909090909,-4.785454545454547,-6.054090909090906,0.15477272727272684,-0.9956818181818221,3.860227272727272,1.975227272727274,0.4336363636363627,1.088181818181818,-2.371363636363636
2022,145,3257,76,3397,64,N,0,12,1,4,-3,1,12,-3,0.36945652173913146,-2.7009782608695616,1.2236956521739133,2.3643478260869575,-1.5513043478260862,-4.834782608695653,-2.2064130434782605,-4.924456521739131,0.7130434782608699,-1.4819565217391322,2.5785869565217405,-1.45913043478261,-0.9048913043478279
2022,145,3276,52,3377,49,N,0,3,3,10,-7,1,3,-7,1.033216783216787,-1.703962703962702,-1.2913752913752914,-3.193240093240094,5.396386946386947,6.1009324009324,2.415151515151516,2.032517482517484,0.9193473193473185,4.884965034965035,0.08531468531468533,-0.6145687645687645,1.2451048951048964
2022,145,3301,66,3323,63,N,0,3,1,5,-4,1,3,-4,1.138322884012542,0.4832810867293631,1.4162095088819218,2.6472048066875686,-0.5852272727272734,-1.3345741901776371,-1.156347962382446,1.9657131661442016,-3.9159482758620694,-2.220088819226749,-2.130028735632184,-2.858281086729363,0.8857758620689644
2022,146,3376,80,3166,50,N,0,30,1,10,-9,-1,-30,9,0.986206896551721,-4.531609195402297,4.427394636015325,11.232279693486593,-2.9307471264367813,-5.993199233716476,-7.5616858237547895,-2.5483716475095797,4.931609195402299,0.2382183908045974,2.2991379310344824,-4.403256704980843,2.5718390804597675
2022,146,3390,59,3400,50,N,0,9,1,2,-1,1,9,-1,-0.3511904761904745,-4.054945054945051,1.5389194139194142,6.216117216117219,-3.4739010989010985,-4.410256410256409,-1.7843406593406588,4.882783882783883,2.1002747252747263,-0.8896520146520146,-3.552655677655677,4.274267399267399,-4.057234432234434
2022,147,3163,91,3301,87,N,2,4,2,1,1,1,4,1,-1.09241379310345,-3.6887356321839064,-0.7464367816091952,-1.0740229885057495,-1.2400000000000002,-1.5774712643678157,-0.0013793103448271893,-3.722758620689657,5.003448275862068,1.507816091954023,1.2625287356321833,2.5487356321839076,-0.30827586206896385
2022,147,3257,62,3276,50,N,0,12,1,3,-2,1,12,-2,0.37909090909090537,1.8974242424242433,0.8006060606060608,0.87439393939394,-4.144848484848485,-5.214393939393938,0.26484848484848555,-0.41136363636363527,0.4325757575757585,-1.2472727272727262,1.3604545454545462,1.3330303030303026,-1.1931818181818201
2022,151,3163,63,3390,58,N,0,5,2,1,1,1,5,1,2.5145238095238085,0.2923809523809524,-0.9473809523809527,-2.8938095238095265,-2.0673809523809528,-4.27,-2.039761904761905,-2.430476190476192,2.8702380952380935,-0.17547619047618923,0.9688095238095231,-3.2478571428571428,-2.437380952380952
2022,151,3376,72,3257,59,N,0,13,1,1,0,-1,-13,0,-0.6937931034482787,-5.543275862068967,-0.10482758620689658,-0.5132758620689639,0.16758620689655146,-2.1543103448275875,-5.737241379310344,-3.309482758620689,-0.8767241379310349,2.626551724137931,4.2891379310344835,-3.1510344827586216,2.030172413793103
2022,153,3376,64,3163,49,N,0,15,1,2,-1,-1,-15,1,0.9162068965517207,-7.108275862068965,0.5351724137931031,1.9317241379310346,-2.6624137931034486,-5.649310344827587,-8.527241379310345,-3.2744827586206924,2.098275862068963,2.036551724137931,3.2941379310344816,-2.6610344827586214,0.5451724137931038
2023,135,3280,70,3228,56,N,0,14,11,11,0,-1,-14,0,2.161111111111108,3.7553030303030326,1.442676767676769,3.1358585858585855,-1.2540404040404063,-3.7623737373737356,0.877272727272727,-2.046969696969697,-1.0760101010101,-2.872222222222222,-2.7116161616161625,-1.3431818181818187,0.1974747474747467
2023,135,3357,57,3380,47,N,0,10,16,16,0,1,10,0,1.9240465416936026,3.941843083387205,0.3307611506140917,4.920551874595992,1.4538017129928882,-0.23773836457660025,1.9217436974789912,2.270301389786681,0.334558823529413,1.8862718164188763,1.2595951842275372,1.3248424369747895,-2.1414229153199713
2023,136,3385,66,3345,64,N,0,2,11,11,0,-1,-2,0,2.4936602870813367,3.6625000000000014,1.5797248803827744,5.878468899521533,0.6735645933014354,0.6489832535885149,-1.5418660287081343,2.9865430622009583,3.298385167464115,1.5959330143540669,2.4944377990430624,-0.3695574162679427,4.096052631578949
2023,136,3399,79,3284,69,N,0,10,16,16,0,-1,-10,0,-0.7027777777777828,-1.666830065359477,1.5197712418300648,3.836928104575165,-2.1805555555555554,-1.6879084967320281,0.12336601307189454,3.1344771241830074,-1.215686274509805,3.9098039215686278,-1.1297385620915037,1.1333333333333333,-3.1235294117647037
2023,137,3112,75,3452,62,N,0,13,7,10,-3,1,13,-3,3.121098200045566,2.4445203918888154,-1.033264980633401,-6.289359763043976,1.0382775119617236,2.154059390901498,1.1011619958988383,-0.5151135414293293,3.2866256550467075,-1.8215235057340315,0.4379129642287527,0.7168679273942433,2.2593605225184206
2023,137,3208,66,3199,54,N,0,12,10,7,3,-1,-12,-3,2.5868310433527846,8.208137273354673,3.4924399272225353,10.290294246815986,2.061327561327561,2.1828220089089676,-0.9803940021331332,5.802716607064433,-1.0590689503732982,-2.8480770437292176,-2.684108162369032,1.7886316581968758,-0.44497772758642284
2023,137,3234,95,3368,43,H,0,52,2,15,-13,1,52,-13,7.692982456140349,5.399122807017534,5.105600539811067,11.244826810616285,5.220197930724247,5.101889338731443,-1.0465587044534415,5.117858749437698,8.367296446243813,1.7848627980206935,-1.3899010346378766,-0.9884165542060277,1.5245164192532634
2023,137,3261,73,3218,50,H,0,23,3,14,-11,-1,-23,11,-7.956349206349209,-11.682539682539684,2.5317460317460316,10.037698412698413,-2.0,-2.617063492063494,-4.601190476190476,-0.31349206349206327,-1.166666666666666,0.8710317460317469,-2.0992063492063497,-2.9940476190476186,-0.799603174603174
2023,137,3268,93,3221,61,H,0,32,2,15,-13,-1,-32,13,-4.494130434782612,-10.538405797101447,-1.5547101449275358,-4.273115942028987,-4.898659420289855,-5.202789855072465,-1.4955072463768122,0.3839855072463756,-2.5860144927536233,1.0610507246376812,-3.3204347826086966,0.22474637681159404,-3.6720289855072465
2023,137,3276,71,3424,59,N,0,12,6,11,-5,1,12,-5,-0.19999999999999574,-8.19444444444445,-1.003030303030303,-5.038888888888891,2.808585858585859,3.6292929292929266,-1.0686868686868678,-1.142929292929292,0.3545454545454554,2.1656565656565654,0.04494949494949463,0.38030303030303036,-1.5595959595959599
2023,137,3279,71,3211,48,N,0,23,8,9,-1,-1,-23,1,-0.27057453416149,-5.588897515527954,3.0318322981366457,2.049301242236023,0.6323757763975149,-2.4906832298136656,-0.8614130434782616,-2.2305900621118013,2.7938664596273277,0.8187111801242235,1.1607142857142847,-1.783385093167702,-2.1358695652173907
2023,137,3280,81,3166,66,N,0,15,11,6,5,-1,-15,-5,-0.7909090909090963,-0.059090909090905086,3.476136363636364,9.68068181818182,-1.9920454545454547,-5.138636363636362,-1.4068181818181813,-2.4125000000000014,0.9681818181818187,-4.945454545454547,-2.77159090909091,-1.9852272727272728,-0.8397727272727273
2023,137,3323,82,3381,56,H,0,26,3,14,-11,1,26,-11,0.44126984126984325,0.5215873015873029,-0.3990476190476189,-1.0603174603174619,0.485079365079363,2.2050793650793636,1.7012698412698413,-1.453650793650791,1.2771428571428576,-0.950793650793651,4.084761904761905,-0.9019047619047615,1.2038095238095234
2023,137,3343,64,3301,63,N,0,1,10,7,3,-1,-1,-3,2.8004940711462467,2.0074110671936793,-0.1354743083003953,1.0169960474308297,1.2060276679841895,1.454743083003951,-1.7471343873517782,2.1855731225296395,-0.45830039525691824,-1.0340909090909083,-1.2206521739130443,0.9927865612648223,-1.992687747035573
2023,137,3355,62,3425,57,N,1,5,9,8,1,1,5,1,3.355952380952381,-0.6476190476190524,-0.0603174603174601,0.2353174603174608,0.6718253968253975,1.365476190476194,-2.390079365079366,4.058333333333334,1.6690476190476176,-0.4428571428571413,-1.6000000000000005,-2.5769841269841267,-0.2674603174603156
2023,137,3376,72,3313,40,H,0,32,1,16,-15,-1,-32,15,-10.315416666666664,-7.029166666666669,-0.5529166666666665,3.2366666666666646,-3.6204166666666673,-3.491666666666667,-4.02,-6.333750000000002,-7.044583333333334,5.622500000000002,5.11125,-5.386666666666667,4.618749999999999
2023,137,3378,67,3266,65,N,1,2,8,9,-1,-1,-2,1,-0.5212454212454176,3.7985347985347957,-0.984981684981685,-1.902747252747254,-3.5538461538461554,-6.0540293040293065,-0.7073260073260084,-1.9750915750915752,1.6419413919413905,-1.52106227106227,2.307142857142858,-0.8727106227106227,-0.5135531135531153
2023,137,3390,92,3357,49,H,0,43,1,16,-15,-1,-43,15,-4.0330963154492565,0.35880736910149125,-1.410310277957337,0.610730446024565,-1.0328054298642542,0.752440206851972,-0.36575630252100666,-5.834162895927605,-5.7565126050420155,1.180914673561734,4.814059469941823,-4.09390756302521,0.830898513251455
2023,137,3428,103,3205,77,H,0,26,2,15,-13,-1,-26,13,-0.6660344827586187,5.510344827586209,-0.3318965517241379,-1.2606896551724134,-1.4941379310344836,-0.01620689655172214,3.3741379310344843,-3.8287931034482767,-5.015862068965516,3.009655172413794,3.8003448275862066,-0.24034482758620657,1.3784482758620697
2023,137,3439,58,3151,33,H,0,25,1,16,-15,-1,-25,15,-2.4907407407407405,-6.379629629629619,-2.0092592592592595,-5.236111111111114,-1.2592592592592595,-2.833333333333332,-3.351851851851853,0.6666666666666643,-2.930555555555557,0.45833333333333215,0.3981481481481479,-0.7407407407407409,-1.4907407407407405
2023,138,3124,78,3104,74,N,0,4,7,10,-3,-1,-4,3,-2.0412280701754355,-5.84210526315789,1.9478070175438589,1.4258771929824583,-0.7293859649122822,-1.5508771929824547,-1.6008771929824555,-3.629385964912281,-4.502631578947369,-0.39912280701754455,0.917105263157894,1.0166666666666666,0.08859649122806701
2023,138,3160,82,3292,60,N,0,22,6,11,-5,1,22,-5,0.9650621118012417,-0.26048136645962927,-3.5760869565217392,-12.691770186335404,-3.392080745341614,-2.6820652173913047,-0.30279503105590067,0.5555124223602483,0.6385869565217384,2.621894409937889,0.637422360248447,-1.3066770186335406,-1.511257763975152
2023,138,3163,95,3436,52,H,0,43,2,15,-13,1,43,-13,4.6742816091954005,4.052155172413791,-0.20488505747126506,-1.0613505747126446,3.541810344827585,3.5244252873563227,0.9010057471264359,4.157040229885062,3.8224137931034505,1.7257183908045963,0.00704022988505848,0.9422413793103441,1.280603448275862
2023,138,3181,89,3233,49,H,0,40,3,14,-11,1,40,-11,-2.3384615384615373,5.558717948717941,-2.6225641025641018,-4.144102564102562,4.552820512820512,6.393846153846155,3.7812820512820533,-0.4592307692307678,-2.5176923076923075,-2.4692307692307693,0.4471794871794881,2.3469230769230767,2.028717948717947
2023,138,3195,74,3450,63,N,0,11,12,5,7,1,11,7,1.2673913043478287,2.31666666666667,4.38913043478261,12.058695652173913,0.22101449275362128,0.9992753623188406,-2.5586956521739133,-1.0311594202898533,0.43478260869565233,-3.713043478260868,0.24782608695652186,-2.3579710144927537,-1.664492753623188
2023,138,3231,77,3399,47,H,0,30,1,16,-15,1,30,-15,5.982407407407408,2.3305555555555557,0.45462962962962994,-0.4685185185185219,2.693518518518518,2.4499999999999993,-2.650925925925927,6.1342592592592595,3.174074074074076,0.6999999999999993,-0.42037037037037095,1.9740740740740743,0.06666666666666998
2023,138,3257,83,3179,81,N,0,2,5,12,-7,-1,-2,7,0.5608256477821705,-1.9458717610891583,1.8585858585858581,7.429622310057091,2.576745718050068,4.111879666227491,-1.7179402722881,6.307312252964429,5.632850241545894,3.529644268774703,-0.32564778216952206,2.298967940272288,-1.5083443126921345
2023,138,3274,62,3329,61,N,0,1,9,8,1,1,1,1,-1.1971690590111663,-0.49062998405103286,-2.7736671223513323,-5.254670767828664,0.8848257006151741,0.834842788790155,3.2711608566871746,-2.098171565276825,0.1980519480519476,2.5119902027796766,1.9462861699703815,-0.7110104807473228,1.5250626566416017
2023,138,3314,61,3385,59,N,0,2,6,11,-5,1,2,-5,2.3139610389610397,8.400595238095235,0.2343614718614715,3.467316017316019,0.5388528138528148,2.5862012987012974,1.319913419913421,2.21498917748918,0.12808441558441785,0.5638528138528152,4.029274891774893,-0.23446969696969733,5.455952380952382
2023,138,3326,80,3241,66,H,0,14,3,14,-11,-1,-14,11,-4.905714285714289,-3.451428571428565,-0.49714285714285644,-0.2142857142857153,1.6714285714285708,1.1314285714285717,2.0685714285714276,4.025714285714287,-4.840000000000002,0.34857142857142875,-4.114285714285715,-0.8914285714285715,-0.2657142857142887
2023,138,3328,85,3339,63,N,0,22,5,12,-7,1,22,-7,4.178452380952379,11.647261904761905,2.154642857142858,5.58047619047619,2.1490476190476198,2.6666666666666714,3.2567857142857157,6.430714285714288,2.7540476190476166,-0.2669047619047653,-1.0734523809523813,0.25916666666666677,5.251428571428573
2023,138,3397,95,3387,50,H,0,45,4,13,-9,-1,-45,9,-1.5402232039060735,1.1372936526389168,0.15624273424784985,3.035456870495235,-1.649848872355264,-3.6588002790048826,-0.3631713554987215,-1.6425249941873972,-0.5746338060916063,1.555452220413855,3.037316903045803,1.7985352243664265,-1.0737037898163209
2023,138,3400,79,3187,40,H,0,39,4,13,-9,-1,-39,9,-5.3399033816425145,-2.081545893719806,-1.1676328502415454,2.1397101449275375,1.2955555555555556,3.029565217391305,-1.2748792270531393,-2.5999033816425126,-2.154589371980677,1.0781642512077294,3.8926570048309195,-1.7799033816425127,-0.1068599033816433
2023,138,3405,80,3235,73,N,0,7,12,5,7,-1,-7,-7,2.2016594516594523,5.138347763347767,2.662878787878787,6.822871572871573,-1.4574314574314577,-2.6148989898989896,1.0387806637806642,2.6693722943722946,0.04202741702741619,-0.11507936507936378,-1.0694444444444446,2.186327561327561,-0.35714285714285765
2023,138,3417,67,3170,45,H,0,22,4,13,-9,-1,-22,9,0.1647619047619031,-10.44920634920635,1.6184126984126985,0.8238095238095262,-2.62984126984127,-2.597142857142856,-2.8584126984126996,0.8447619047619028,-1.2196825396825393,3.2923809523809524,-2.854920634920634,-0.5749206349206348,-2.752063492063492
2023,138,3437,76,3156,59,H,0,17,4,13,-9,-1,-17,9,-1.664285714285711,-1.8297619047619023,0.40357142857142847,-2.482142857142861,5.447619047619046,7.966666666666665,1.7738095238095237,1.8428571428571416,-1.4714285714285715,5.359523809523809,1.3892857142857142,-0.9511904761904759,-0.6678571428571445
2023,139,3234,74,3208,66,H,0,8,2,10,-8,-1,-8,8,-5.251082251082252,-4.267316017316013,-5.698218448218449,-13.845571095571096,-2.3604728604728606,-1.9680319680319691,3.2957042957042963,-6.007659007659008,-4.684149184149183,1.1837329337329336,3.3111055611055615,0.8532301032301031,2.253413253413253
2023,139,3261,66,3276,42,H,0,24,3,6,-3,1,24,-3,2.6666666666666643,7.099206349206348,-1.7445887445887447,-5.248015873015872,-1.0133477633477632,-0.12572150072149668,3.886544011544011,0.20959595959595845,-2.2283549783549788,-2.357323232323232,1.8860028860028875,2.737554112554112,2.108405483405484
2023,139,3268,77,3112,64,H,0,13,2,7,-5,-1,-13,5,-0.43952380952381276,-0.9214285714285637,-0.8142857142857141,-2.73714285714286,-2.8633333333333333,-1.1684126984126983,0.7638095238095239,-2.1946031746031736,-1.8114285714285714,-2.451587301587301,0.536190476190475,-0.045396825396825324,1.1469841269841297
2023,139,3279,54,3390,49,A,0,5,8,1,7,1,5,7,-1.5258540372670808,2.5281832298136706,-2.0854037267080745,-2.845729813664594,-0.578804347826086,0.8513975155279532,-0.07787267080745153,-3.8336956521739154,-4.7867236024844715,-0.407996894409937,2.2642857142857142,-1.9701863354037261,0.6930124223602476
2023,139,3323,53,3280,48,H,0,5,3,11,-8,-1,-5,8,0.6000000000000014,-0.19500000000000028,1.3549999999999995,1.049999999999999,-1.2699999999999978,-1.0650000000000013,-0.7599999999999998,0.26000000000000156,0.5549999999999997,-0.3000000000000007,0.370000000000001,0.665,0.620000000000001
2023,139,3376,76,3378,45,H,0,31,1,8,-7,1,31,-7,6.154647435897438,8.075320512820511,-1.2668269230769234,-3.78846153846154,2.773237179487179,4.535256410256409,5.564102564102564,3.542467948717949,3.0184294871794854,-2.4407051282051277,1.802083333333334,5.615384615384615,-0.14182692307692335
2023,139,3428,63,3343,56,H,0,7,2,10,-8,-1,-7,8,-2.9741304347826087,1.563043478260873,-1.930434782608696,-6.466086956521739,-5.362391304347826,-6.125652173913043,2.08804347826087,0.042608695652177175,-2.147608695652174,-0.45500000000000007,1.6356521739130443,-0.3136956521739127,-2.53913043478261
2023,139,3439,72,3355,60,H,0,12,1,9,-8,-1,-12,8,1.7620370370370395,0.9588624338624356,-1.3116402116402117,-3.4412698412698433,1.650661375661377,2.301984126984131,-0.2935185185185194,4.294444444444444,1.3396825396825385,1.0829365079365072,1.4489417989417985,-0.19272486772486763,-0.3613756613756607
2023,140,3160,61,3181,53,A,1,8,6,3,3,1,8,3,2.31268115942029,1.010471014492758,0.5689130434782603,0.9060869565217384,2.264347826086958,3.994601449275361,0.7826811594202887,0.3883695652173884,1.6819202898550714,-0.725724637681159,1.6178985507246377,-3.0290579710144927,1.2777898550724665
2023,140,3163,77,3124,58,H,0,19,2,7,-5,-1,-19,5,-0.28722020568663,5.9774500907440995,1.1237447065940716,6.3146400483968534,-1.4749243799153042,-0.25688142770719935,1.3457047791893526,-1.1318209316394459,0.4802177858439194,-0.3474289171203857,2.0466878402903808,-1.358908045977011,1.3433000604960696
2023,140,3257,73,3400,51,A,0,22,5,4,1,1,22,1,-0.7680983750548975,-2.2804918752744854,1.1727272727272737,3.3147211242863435,0.3475977162933681,-1.7422837066315324,-3.499736495388669,1.096627140974963,-0.38537549407114646,-0.062371541501976324,-0.2858673693456293,-2.2770487483530966,-1.6062011418533189
2023,140,3274,70,3231,68,A,0,2,9,1,8,-1,-2,-8,3.5338693957115055,-1.110380116959064,1.3131091617933723,1.7022417153996088,2.775828460038987,1.6059941520467866,-4.249756335282653,3.5962475633528257,3.324074074074076,-1.7565789473684212,-1.7899610136452253,2.321881091617934,0.9035087719298289
2023,140,3326,71,3314,69,H,0,2,3,6,-3,-1,-2,3,-3.2242857142857133,-1.8476190476190482,-1.0576190476190472,-2.6361904761904746,-0.7823809523809526,-1.5228571428571414,0.8923809523809538,0.8104761904761943,-3.9714285714285715,0.2319047619047616,-0.925238095238095,0.12380952380952337,-0.1376190476190473
2023,140,3397,94,3405,47,H,0,47,4,12,-8,1,47,-8,3.8427442123094337,6.9414878599661165,-0.795948616600791,-3.3064652738565776,-0.6799830604178432,0.6220355731225311,5.393633540372671,0.18979390175042354,0.4265245623941265,1.7869847543760606,-0.3829051383399209,1.6331874647092037,1.7900903444381697
2023,140,3417,82,3328,73,H,0,9,4,5,-1,-1,-9,1,3.4099999999999966,1.4255555555555617,0.8822222222222225,1.2166666666666686,1.6211111111111123,2.993333333333336,-0.5855555555555547,4.32,4.3888888888888875,4.866666666666664,-0.6777777777777771,-0.7811111111111111,1.9455555555555577
2023,140,3437,76,3195,57,H,0,19,4,12,-8,-1,-19,8,0.9190476190476211,-2.029761904761898,5.120238095238095,10.201190476190476,-0.5607142857142868,0.3999999999999986,-2.8511904761904763,-0.9821428571428577,0.6785714285714288,1.692857142857143,0.605952380952381,-3.7678571428571432,-3.1178571428571438
2023,144,3234,87,3160,77,N,0,10,2,6,-4,-1,-10,4,-6.320652173913043,-3.6295289855072426,-4.02159977703456,-9.064938684503904,-2.9392419175027875,-1.9769370122631003,2.910117056856188,-4.378553511705686,-5.848592530657747,0.010172798216276036,2.7894370122631003,0.20889074693422494,2.928302675585286
2023,144,3257,72,3279,62,N,0,10,5,8,-3,1,10,-3,1.5980731225296445,-1.1563735177865624,0.7509881422924902,-0.3011363636363633,0.21417984189723072,-1.4723320158102773,-0.5778162055335976,-0.8463438735177888,2.9977766798418966,0.9449110671936758,1.1185770750988144,-1.7356719367588935,-0.6931818181818201
2023,144,3261,66,3428,63,N,0,3,3,2,1,1,3,1,2.7650000000000006,6.521428571428572,-3.4642857142857144,-11.44357142857143,-2.2164285714285707,-1.6264285714285691,3.7928571428571427,0.46000000000000085,-2.472142857142858,-0.6799999999999997,2.7042857142857155,1.9628571428571426,-0.8678571428571438
2023,144,3274,70,3437,65,N,0,5,9,4,5,1,5,5,1.4370300751879697,-1.058270676691727,-0.518796992481203,-4.1751253132832105,1.6375313283208008,2.866228070175435,1.9448621553884724,0.875313283208019,0.17857142857142883,5.899436090225564,1.5366541353383472,-3.348997493734336,-0.4213659147869713
2023,145,3268,76,3323,59,N,0,17,2,3,-1,1,17,-1,2.030000000000001,5.796666666666667,2.046666666666667,4.313333333333334,2.243333333333334,0.4633333333333347,-1.2666666666666657,-1.6533333333333324,0.9866666666666664,-1.8833333333333346,1.2600000000000016,-0.9733333333333336,2.633333333333333
2023,145,3326,73,3163,61,N,0,12,3,2,1,-1,-12,-1,-1.3279802955665048,-6.6960591133004925,-1.385123152709359,-6.882660098522166,0.4421674876847277,-1.7115270935960574,-0.4905418719211827,4.1919211822660145,0.5581280788177345,2.0736945812807868,-4.50807881773399,0.8743842364532011,-2.375467980295568
2023,145,3376,59,3417,43,H,0,16,1,4,-3,1,16,-3,6.352083333333333,0.9747222222222263,-2.738194444444445,-8.673333333333332,3.018194444444445,6.035,3.684444444444445,6.477083333333333,2.9101388888888895,0.6841666666666661,-1.0790277777777773,5.022222222222222,-4.286527777777778
2023,145,3439,73,3397,64,N,0,9,1,4,-3,-1,-9,3,3.9154955350607565,6.0182074366856995,-2.3468745425267166,-6.20130654369785,2.3742497438149606,3.3025911286780882,4.035829307568438,2.741381203337724,0.8769213877909525,2.2770641194554244,1.6124652320304493,0.26546259698433605,2.1287146830625083
2023,146,3234,97,3257,83,N,0,14,2,5,-3,1,14,-3,3.399209486166008,1.0793807641633677,3.7977855477855478,9.580748961183744,3.3582142495186,4.41937772372555,-3.264366068713895,3.4069626026147795,4.872554981250632,-0.05019256106212566,-1.16344886997061,-1.2775666362622884,-2.096533900881724
2023,146,3261,54,3274,42,N,0,12,3,9,-6,1,12,-6,3.1820175438596507,4.683270676691727,-1.2252506265664165,-5.027255639097744,0.9636591478696754,1.520676691729328,1.4718045112781937,0.22587719298245545,-1.3571428571428577,-1.8815789473684212,0.4335839598997495,3.015664160401002,0.8023182957393509
2023,147,3376,86,3268,75,H,0,11,1,2,-1,-1,-11,1,-3.5887499999999974,-0.2958333333333343,1.8604166666666666,5.713333333333335,-0.7304166666666667,-3.5716666666666654,-6.906666666666666,-5.657083333333333,-1.3745833333333337,1.3791666666666664,2.7212500000000013,-6.113333333333333,3.2820833333333326
2023,147,3439,84,3326,74,N,0,10,1,3,-2,-1,-10,2,5.018465608465611,7.458862433862436,-0.5373544973544977,-0.21341269841270005,-0.4443386243386236,0.7498412698412693,0.4771957671957665,-0.23626984126984496,2.3753968253968267,0.5200793650793649,5.114656084656085,0.2715608465608468,1.7000529100529107
2023,151,3234,77,3376,73,N,0,4,2,1,1,1,4,1,-0.71875,-3.2291666666666714,4.664262820512821,11.391025641025642,-0.3501602564102555,-2.0801282051282044,-8.73076923076923,-2.2668269230769234,2.2059294871794854,2.209935897435898,0.2363782051282044,-6.801282051282051,0.8149038461538467
2023,151,3261,79,3439,72,N,0,7,3,1,2,1,7,2,5.787037037037038,8.344576719576722,-3.39021164021164,-10.234126984126986,0.9470899470899479,1.3591269841269877,3.7493386243386233,0.5694444444444429,-0.7460317460317469,0.47222222222222143,4.0846560846560855,2.096560846560846,1.4636243386243386
2023,153,3261,102,3234,85,N,0,17,3,2,1,-1,-17,-1,1.0,-2.988095238095241,5.034798534798536,13.194597069597071,1.8150183150183157,1.491300366300365,-5.248626373626373,3.5769230769230766,6.094322344322343,1.2724358974358978,-2.009157509157511,-3.0691391941391934,-1.885989010989011
